elita	elite
topildi	found
shifokor	doctor
avtoritar	authoritarian
sertifikatlar	certificates
led	led
skelet	skeleton
muxtoriyat	autonomy
klarnet	clarinet
olqishlar	applause
vakili	representative
bolta	axe
hisoblar	calculations
klaster	cluster
yunus	dolphin
taqriban	approximately
etakchilik	leadership
issiq	hot
patologik	pathological
it	dog
kuchlanish	voltage
yana	anew
ob-havo	weather
mutaxassislar	experts
tovuq	chicken
javob	answer
umidsizlik	disappointment
ha	yes
ozod	free
dushman	enemy
sigirlar	cows
gollandcha	dutch
amaliyotchilar	practitioners
dermatologiya	dermatology
barchasi	aggregate
qimmatli	precious
amfibiyalar	amphibians
izlari	traces
narsa	article
pnevmatik	pneumatic
suriya	syrian
himoyachi	advocate
erishmoq	achieve
atletika	athletics
sinflar	classes
kabi	as
toshlar	stones
shirinliklar	sweets
mohirona	artistic
planshet	tablet
shamol	wind
uzun	long
deputat	deputy
taklif	offer
serharakat	active
piket	picket
butunlikni	integrity
salbiy	negative
yangi	new
karbunkul	anthrax
agentligi	agency
jinsi	sex
transmitterlar	transmitters
atirgul	rose
cheklov	restriction
tizmalar	ridges
tabriklash	greeting
qat	crease
shubha	doubt
aromatik	aromatic
aniqlovchi	attribute
psixologlar	psychologists
tibetliklar	tibetan
yoqtirmaslik	aversion
rezavorlar	berries
shishgan	swollen
minoralar	towers
zararkunanda	pest
ulamolar	printers
salonlari	salons
direktor	director
stipendiya	scholarship
yaylovlar	pastures
zaharlanish	poisoning
alternativ	alternative
transseksual	transsexual
axloqiy	ethical
kuch	power
himoyachilar	defenders
allergiya	allergy
kuchaytirgichlar	amplifiers
sahnalar	scenes
balerina	ballerina
saqlash	save
aktrisa	actress
kodek	codec
statistika	statistics
kasalxonalar	hospitals
tomonlari	aspects
ramziy	symbolic
tarqatish	distribution
aloqa	communication
sanitariya	sanitary
chegirmalar	discounts
maks	max
baliqchi	fisherman
foyda	profit
soddalashtirilgan	simplified
subsidiya	subsidy
dizayn	design
qisqartirildi	shortened
portlashlar	explosions
qabilalar	tribes
rozilik	agreement
mikrofon	microphone
ustuvorliklar	priorities
bahs	argument
keyingisi	next
birodar	brother
koinot	universe
qisqich	antenna
muzlatilgan	frozen
berilish	award
sezgir	sensitive
raqamlar	numbers
qonun	act
biologlar	biologists
vorisi	successor
kesib	cross
ayblovlar	accusations
ontologiya	ontology
murda	corpse
embrion	embryo
hozir	now
uchinchidan	thirdly
adolatsizlik	injustice
nafaqa	allowance
mustamlaka	colonial
xavfsizlik	security
tizma	ridge
orzular	dreams
partiya	party
alpinistlar	climbers
futbol	football
ruhoniy	priest
inqiroz	crisis
millatchilik	nationalism
behuda	absurd
moslashtirishlar	adaptations
galaktika	galaxy
gastroenterologiya	gastroenterology
pediatriya	pediatrics
yuborilgan	sent
praga	prague
bosqin	attack
gullar	flowers
kuydirgi	anthrax
oddiy	usual
nomlangan	named
diabetik	diabetic
nusxa	copy
agrar	agrarian
karavot	bed
radio	radio
boshpana	accommodation
yonma-yon	alongside
haqiqiy	real
pravoslav	orthodox
muammoli	problematic
akr	acr
geofizika	geophysics
kinoya	allusion
epidemik	epidemic
yulduz	star
fohisha	prostitute
madaniyatlari	cultures
bulut	cloud
chipqon	abscess
sovutish	cooling
tubsizlik	abyss
iqlimli	climatic
diplomatlar	diplomats
usta	master
qilichlar	swords
yordam	aid
hukm	judgment
fotosuratlar	photographs
ortopediya	orthopedics
tushuntirishlar	explanations
dard	anguish
polimerlar	polymers
psixologiya	psychology
hazil	joke
olma	apple
oddiylik	simplicity
mashq	exercise
mantiqiy	logical
oshqozon	stomach
yovvoyi	wild
eshik	door
amaliyot	practice
qarorgoh	accommodation
qatronlar	resin
muzeylar	museums
jarrohlik	surgery
nashriyotchi	publisher
bloklari	blocks
jangchilar	warriors
havzasi	basin
pragmatik	pragmatic
uchi	tip
ekan	that
integrallashgan	integrated
narsalar	things
eklektik	eclectic
dengizlar	seas
bukletlar	booklets
izdoshi	follower
yaponiya	japan
ayyor	artful
dushmanlar	enemies
benzin	gasoline
yosh	age
tartibsizlik	irregular
adyol	blankets
ishlar	works
rezonans	resonance
teatrlar	theaters
intizom	discipline
moslashtirish	adaptation
xabardor	aware
optimallashtirish	optimization
iztirob	anguish
qutqarildi	rescued
kaptar	pigeon
prefektura	prefecture
asbob	accessory
mezbon	host
tezlashtirish	acceleration
diskret	discrete
muassasalar	institutions
oldin	before
hodisa	case
epizod	episode
parishon	absent-minded
kasalliklar	diseases
amortizatsiya	depreciation
ekrani	screen
taxmin	guess
genlar	genes
tashqari	except
afsona	myth
port	port
palto	coat
plagin	plugin
kraxmal	starch
hali	still
janr	genre
yaroqli	able-bodied
quchoqlashadi	embracing
topografik	topographic
minimallashtirish	minimization
mexanika	mechanics
qamoqxonalar	prisons
kichik	small
ishlatilgan	used
xarita	map
vint	screw
erkaklar	men
shimoliy	north
vakansiyalar	vacancies
tegdi	touched
eslayman	remember
edi	been
xamsa	anchovy
bino	building
quloqlar	ears
magnit	magnetic
koptok	ball
intilish	ambition
apparati	apparatus
ism	name
avtomobil	automobile
uchrashuv	appointment
eshak	donkey
rejimi	mode
mayo	swimsuit
qobiliyat	ability
termo	thermo
past	low
ostida	underneath
zavq-shavq	ardour
panjara	grill
semantik	semantic
qotillar	killers
kanalizatsiya	sewage
bomba	bomb
imtiyoz	privilege
emaye	enamel
ijobiy	affirmative
qatlamli	layered
terak	poplar
normalar	norms
lahjalar	dialects
olma	apple
rentabellik	profitability
advokat	attorney
minalar	mines
shuhrat	fame
masofa	distance
tasalli	relaxing
sabzi	carrot
biri	one
dum	tail
serb	serbian
parazitar	parasitic
ruh	spirit
anneksiya	annexation
istaydi	wants
tinglovchi	audience
qadam	step
istak	aspiration
mavjudligi	availability
devorlar	walls
allellar	alleles
kriteriyalar	criteria
chuqurroq	deeper
chetga	aside
oldinga	ahead
xoreografiya	choreography
charchoq	fatigue
davolash	treatment
vatanparvarlar	patriots
korxonalar	businesses
bankirlar	bankers
faktoring	factoring
aseptik	aseptic
maydon	area
qozongan	winning
komponenti	component
oshiqona	amorous
fosfor	phosphorus
xona	room
boshpana	asylum
kalamushlar	rats
koko	coco
yodgorliklar	monuments
botmon	batman
zavqli	amusing
ham	too
reklama	ad
prezidentlari	presidents
hislar	senses
anomaliya	anomaly
assimetrik	asymmetric
timsoh	alligator
tajriba	experience
kamonchi	archer
ittifoqdosh	ally
band	busy
bayonot	allegation
deraza	window
qisqartmalar	abbreviations
texnik	technical
parklar	parks
stereotiplar	stereotypes
baliq	fish
karton	carton
tomoshabin	viewer
raqiblar	opponents
gitara	guitar
diod	diode
haftalar	weeks
vatan	homeland
platforma	platform
ish	work
begunoh	innocent
labirint	labyrinth
ot	horse
avtomobil	car
verner	werner
markazlashtirilgan	centralized
kirishlar	inputs
provokatsion	provocative
ochildi	opened
tomonga	toward
ulanish	connection
degani	mean
hech	ever
qalam	pen
manba	source
nayzalar	spears
belgilamoq	assign
avtonom	autonomous
sen	you
harakat	attempt
qaror	solution
qiyin	austere
na	nor
hisobchi	accountant
funktsiyasi	function
erishish	acquisition
antarktika	antarctic
soqolli	bearded
septik	septic
oshxona	kitchen
haqorat	affront
aybdor	accountant
mexnat	cocktail
protokollari	protocols
siz	you
xaos	chaos
evropa	european
jinoyat	crime
ofitserlar	officers
qopqoqlar	lids
tengsizlik	inequality
laganda	tray
sertifikatlash	certification
ishonmoq	ascertain
dedi	said
aqliy	mental
lider	leader
edi	was
kashshof	pioneer
zargarlar	jewelers
tomchilar	drops
pishgan	ripe
genotip	genotype
ahdnoma	agreement
stantsiyani	station
isbotlangan	proven
eshak	ass
tajribasiz	inexperienced
mandatlar	mandates
shoir	poet
yoki	or
xiyonat	adultery
ergonomika	ergonomics
kinematografiya	cinematography
mikroorganizmlar	microorganisms
darsliklar	textbooks
liturgik	liturgical
mafkura	ideology
sharhlovchi	commentator
dengizda	afloat
nutq	address
paradigmalar	paradigms
obstruktiv	obstructive
boshi	head
kodi	code
gormonlar	hormones
tepalik	hill
bozorlar	markets
zavod	factory
erishmoq	attain
tengdoshlar	peers
shriftlar	fonts
yankilar	yankees
vahima	anxiety
suiqasd	assassination
portfeli	portfolio
muvofiqlashtirish	coordination
somatik	somatic
suhbat	talk
choynak	teapot
pul	money
pushaymon	regret
tushunarli	understandable
vahiy	revelation
delfinlar	dolphins
fiziologik	physiological
shamolli	windy
yuklaydi	loads
boshlanishi	beginning
ateizm	atheism
harakati	movement
gomoseksuallar	homosexuals
sahna	scene
protokol	protocol
yelkalar	shoulders
ligasi	league
tuyaqush	ostrich
braziliyalik	brazilian
qurollanish	armament
jazolash	punish
takrorlash	repetition
yonadi	flashes
ashyo	material
professorlar	professors
biomassa	biomass
zahar	poison
noaniq	uncertain
moliyalashtirildi	funded
kardinal	cardinal
funktsional	functional
sharpa	apparition
akrobat	acrobat
dalil	fact
tanqid	criticism
quvur	pipe
aprel	april
haydash	drive
sigaretalar	cigarettes
psixiatrik	psychiatric
nukleotid	nucleotide
esa	and
ruxsat	let
kulrang	gray
granit	granite
muhlat	respite
kulbani	hut
antik	antique
piksel	pixels
yorqinroq	brighter
bodom	almond
haqoratli	abusive
mohirona	ably
kuldon	ash-tray
keng	broad
qichqiriq	scream
sham	candle
burilish	turn
ashulachi	singer
yaqinlik	affinity
kuyov	groom
uy	home
tashrif	visit
qulay	comfortable
uyushmasi	association
ishchan	active
zaif	weak
perpendikulyar	perpendicular
qadimgi	archaic
tovarlar	commodities
optimizm	optimism
balandligi	height
antikvar	antiquarian
qator	row
novvoylar	bakers
sherik	ally
tumanlik	nebula
yopishqoqlik	adhesive
topologik	topological
termoplastik	thermoplastic
botir	audacious
xabarnomalar	notifications
qarshi	against
til	language
kirpi	hedgehog
telegramma	telegram
sevimli	adorable
zarar	harm
malika	queen
oshirish	rise
homiladorlik	pregnancy
siyosatchilar	politicians
tranzistorlar	transistors
nashavand	addict
samolyotda	aboard
qonuniy	legal
aylandi	turned
vasvasa	temptation
advokat	advocate
ehsonlar	donations
haykaltarosh	sculptor
fondi	fund
baqlajon	eggplant
shtamplash	stamping
termoyadroviy	fusion
gunohkor	sinner
ziddiyat	contradiction
idish	container
jihozlar	apparatus
kabi	like
atmosfera	atmosphere
tashkil	arrange
havo	air
voy	woe
tashvish	trouble
mavjudlik	accessibility
ishqiy	romantic
yashirincha	secretly
sinaptik	synaptic
dasturlari	programs
dorilar	medicines
emulyatorlar	emulators
yutuqlar	achievements
tekshiruv	assay
boks	boxing
surat	picture
agentlik	agency
oldingi	previous
logotipi	logo
reproduktiv	reproductive
siydik	urine
biopsiya	biopsy
tuyulgan	vision
bosqinchi	aggressive
kelishuv	agreement
qichqirmoq	shout
estetika	aesthetics
bizga	us
lager	camp
sotsiologiya	sociology
tushgan	falling
talabalar	students
qoplonlar	tigers
savol	question
fondlari	funds
vosita	engine
prussiya	prussia
terminologiya	terminology
olqishlamoq	applaud
turnirlar	tournaments
mikron	micron
velosipedlar	bicycles
konfeti	confetti
ozchilik	minority
eskirgan	archaic
qonunlar	laws
ulanish	connect
arpa	barley
huquqshunos	attorney
osiyo	asian
egri	curve
qahrabo	amber
filogenetik	phylogenetic
uylar	houses
dona	pcs
roll	roll
aktsiz	excise
qovun	melon
prizma	prism
vazifa	assignment
oyat	verse
nomzodlar	candidates
amorf	amorphous
nemischa	german
ohu	antelope
antennalar	antennas
marksizm	marxism
qoplash	covering
tutmoq	catch
yangilanishlar	updates
qahva	coffee
kreslo	arm-chair
tuzatmoq	adjust
sinovchi	tester
meni	me
konsertlar	concerts
grafiti	graffiti
davr	period
chumchuq	sparrow
tasvir	aspect
samarasiz	ineffective
evolyutsiyasi	evolution
prokuror	attorney
qism	part
ekspeditsiyalar	expeditions
chodir	tent
qochish	escape
class	class
mehribonlik	kindness
hammom	bathroom
gulchambar	wreath
ogohlantiradi	warns
tayyor	ready
xayol	dream
ofset	offset
ifoda	phrase
hokim	governor
mikroskopi	microscopy
dan	from
qovoq	pumpkin
song	song
uglevodorod	hydrocarbon
skriptlar	scripts
tarqalishi	spread
kelmagan	absent
diodlar	diodes
ellips	ellipse
pichirlash	whisper
kislota	acid
shakli	shape
madaniyatlararo	intercultural
quyoshli	sunny
arxeologik	archaeological
echkilar	goats
aybsizlik	innocence
maqtov	praise
tanlash	choice
josuslik	spy
antibiotiklar	antibiotics
torting	pull
kema	ark
olish	get
tovushlar	sounds
kosib	artisan
yulduzlar	stars
pudratchilar	contractors
mongoliya	mongolia
kartoshka	potatoes
oksid	oxide
malavi	malawi
xitob	apostrophe
yoritilgan	alight
farovonlik	prosperity
klublari	clubs
yilligi	anniversary
chiquvchi	outgoing
nishonlandi	celebrated
yaqinda	soon
yosh	adolescent
konkord	concord
yoyiq	spatial
tetik	trigger
magnoliya	magnolia
xulq	attitude
stantsiya	station
oddiygina	simply
animatsiya	animation
akustika	acoustics
alpinizm	mountaineering
pasportlar	passports
valyutalar	currencies
tribun	tribune
qamish	reed
kelishgan	handsome
genom	genome
avtomobilchilar	motorists
portallar	portals
hisoblash	count
xaltadan	sack
subsidiyalar	subsidies
vahshiy	atrocious
yuqori	above
xronikalar	chronicles
intizomli	disciplined
piramida	pyramid
simpozium	symposium
qishloqlar	villages
fizik	physicist
yahudiy	jewish
yaqinida	alongside
simlar	wires
dielektrik	dielectric
saqlanadi	stored
inqilobiy	revolutionary
translyatsiyalar	transmissions
aylanish	rotation
suzish	swimming
jamoat	church
tushirildi	lowered
polifonik	polyphonic
afzalliklari	advantages
norozi	dissatisfied
qotishmalar	alloys
sharq	east
liberallashtirish	liberalization
faoliyat	operate
zarracha	particle
biolog	biologist
katalogi	catalog
tomoshabinlar	viewers
tomlar	roofs
balon	balloon
soat	alarm-clock
quruvchilar	builders
tarvuz	watermelon
asteroidlar	asteroids
moddalar	substances
majburiyatlar	liabilities
odam	human
pergament	parchment
izohlar	comments
ifodali	expressive
uzuklar	rings
plitkalar	tiles
xabarlar	messages
inoyat	grace
bolalik	childhood
qaytaradi	returns
kesmoq	amputate
cheksiz	absolute
signallarini	sat
siqilgan	compressed
mikrobiologiya	microbiology
proteinlar	proteins
irratsional	irrational
filo	fleet
yopishtiruvchi	adhesive
organlari	organs
hujjatsiz	undocumented
rumincha	romanian
hujum	attack
azalgi	aboriginal
mukammallik	acme
kesh	cache
aeroport	airport
politexnika	polytechnic
janubiy	south
burjua	bourgeois
madaniyatli	civilized
nomsiz	anonymous
baland	audible
ritorik	rhetorical
uran	uranium
achchiq	acrid
korruptsiya	corruption
ekilgan	planted
munosabatlar	relationships
yoki	either
quyma	alloy
chetga	aside
novvoy	baker
apostrof	apostrophe
parij	paris
agrar	agrarian
kakao	cocoa
anomaliyalar	anomalies
regressiya	regression
ishonchli	reliable
tarjimonlar	translators
moderatorlar	moderators
sirlangan	glazed
pirsing	piercing
glyukoza	glucose
qaram	ancillary
shtapel	staple
samolyotlar	airplanes
brigada	brigade
muqaddas	holy
mohiyat	essence
mexanizmlari	mechanisms
nomenklatura	nomenclature
muzey	museum
mantiya	mantle
husnbuzar	acne
patentlar	patents
ichiga	into
qimor	gambling
kuchaytirgich	amplifier
kvintet	quintet
monografiya	monograph
tez	fast
shampun	shampoo
rasmlar	pictures
xususiy	own
hal	settle
chivinlari	flies
hunarmand	artisan
logotiplar	logos
zenit	zenith
ozodlik	freedom
libos	apparel
nomzod	candidate
badan	body
kolit	colitis
boyroq	richer
karbid	carbide
yaqin	around
maysazorlar	lawns
noutbuklar	notebooks
pasxa	easter
qurollangan	armed
murch	pepper
aerozol	aerosol
formati	format
tarbiyachi	educator
kutish	wait
turi	type
loson	lotion
muallif	author
lateks	latex
sehrgarlik	sorcery
marjonlarni	necklaces
festivallar	festivals
allaqachon	already
arabcha	arabic
portret	portrait
biosintez	biosynthesis
tormozlanadi	brake
zolimlik	atrocity
tezlatgichlar	accelerators
parad	parade
birlashgan	united
qish	winter
vidjet	widget
avtograf	autograph
vaqtinchalik	temporary
skripka	violin
boyqush	owl
takabburlik	arrogance
masjid	mosque
manzilgoh	address
hovuch	handful
tayoq	stick
maqsad	goal
avlod	generation
kuzatilgan	observed
string	string
rels	rail
boshqa	another
hasharot	insect
chaqmoq	lightning
yordamchi	ancillary
transformator	transformer
pianinochi	pianist
kreyser	cruiser
musiqa	music
xususiyatlari	features
hamyon	wallet
repertuar	repertoire
tahlilchi	analyst
vakolatxonalar	representations
signallari	signals
kompressorlar	compressors
boshqarish	management
belkurak	shovel
tushunish	appreciation
zavq	admiration
metil	methyl
ishtaha	appetite
muzliklar	glaciers
xulosa	summary
koridor	aisle
kalitlari	switches
loyihalar	projects
endokrinologiya	endocrinology
gazak	appetizer
uyatchang	shy
muddat	term
serjant	sergeant
kamida	least
zarba	hit
vositachi	mediator
deyarli	about
qumli	sandy
xorijiy	foreign
bekat	station
polietilen	polyethylene
reaktiv	reactive
protsessorlar	processors
fut	feet
xotiralar	memories
lekin	but
reaktorlar	reactors
faqatgina	only
anik	thematic
kesish	cut
huquq	authority
qari	aged
oldi	took
ijrochi	executive
neft	oil
bostirma	awning
istak	wish
limonad	lemonade
qopqoq	cover
mehmon	guest
kanon	canon
kometa	comet
xitoycha	chinese
konsentratlar	concentrates
aniqlik	accuracy
foydalanuvchi	user
ovqat	eat
iltimos	please
idora	administration
garaj	garage
taraqqiyot	advance
nusxalash	copying
azizlar	saints
qotishma	alloy
mazmunli	meaningful
agentliklari	agencies
bulvar	boulevard
konusni	cone
ayrim	apart
buldog	bulldog
fotosuratchi	photographer
kuya	moth
rekombinatsiya	recombination
ommaviy	public
oz	less
itoatkor	obedient
qisman	partly
empirik	empirical
vengercha	hungarian
chuqur	deep
tashvishli	anxious
atrof-muhit	ambience
pedagogika	pedagogy
orqali	across
dasturchi	programmer
antioksidant	antioxidant
imperiya	empire
komissari	commissioner
alomatlar	symptoms
yuqorida	above
bloglar	blogs
aroq	vodka
ittifoq	alliance
takroran	anew
diqqat	attention
unitar	unitary
dehqon	farmer
millatlar	nations
taxminan	around
raqs	dance
subtitrlar	subtitles
shahidlar	martyrs
qullar	slaves
mexanizm	mechanism
mavhum	abstract
mehribon	kind
fokuslar	tricks
fikr	idea
klan	clan
inflyatsiya	inflation
daraja	level
shohlik	kingdom
sadaqa	alms
uyatchan	abashed
sitologiya	cytology
mos	adequate
qumlarni	sands
hidoyat	guide
aktuar	actuarial
xolesterin	cholesterol
samuray	samurai
varaqalar	leaflets
yuqori	aloud
maydon	arena
kek	cake
sayohat	trip
materik	mainland
muloyim	gentle
seriyali	series
miltillovchi	blinking
usuli	method
qadamlar	steps
sodir	happen
itarish	pushing
komstok	comstock
tushunmoq	appreciate
pnevmoniya	pneumonia
antropologik	anthropological
sxemasidan	pallets
oltingugurt	sulfur
uchuvchisiz	unmanned
muskul	muscle
marmar	marble
videolar	videos
asir	captive
choralar	measures
pornografiya	pornography
xanjar	dagger
oyoq	leg
zararsiz	safe
yonayotgan	burning
ish	act
geosiyosiy	geopolitical
qaror	decide
markali	branded
tuzatmoq	amend
quritmoq	air
kelishuv	deal
prostata	prostate
hukumatlararo	intergovernmental
muolajalar	treatments
oyoqli	footed
xudosizlik	atheism
shikoyatlar	complaints
intensiv	intensive
ipak	silk
muhim	important
yurak	heart
formatlangan	formatted
shartnoma	contract
matnlar	texts
keti	kathy
qolib	mold
kod	code
feromon	pheromone
shaharlari	cities
kanoe	canoe
muxbirlari	correspondents
momaqaldiroq	thunder
kollektor	collector
tez	abrupt
affiks	affix
musulmonlar	muslims
radiatorlar	radiators
yuksaklik	acme
faylasuflar	philosophers
qoida	rule
respublikachilar	republicans
quturgan	rabies
qalin	thick
stenoz	stenosis
jadvallar	tables
menyu	menu
oilaviy	family
eslatma	reminder
ertalab	morning
uilyam	william
karamel	caramel
komissiyalar	commissions
miqyosli	scale
faollashtiradi	activates
albomlar	albums
trillerlar	thrillers
uchqun	spark
ekonometrik	econometric
tadqiqot	research
makaron	pasta
sotish	sale
amnistiya	amnesty
samaradorligi	effectiveness
orzu	aspiration
bankir	banker
qarash	attention
molekulasi	molecule
tugatmoq	abolish
qullik	slavery
afzallik	advantage
payvandlangan	welded
tarqaldi	spread
anons	announcement
multimediya	multimedia
ajratmoq	divide
nasr	prose
hayajon	excitement
qatlam	layer
leykemiya	leukemia
tavsiyalar	recommendations
muhitlar	environments
eslatma	note
dam	rest
sayohat	travel
terish	dial
yubileylar	anniversaries
nogironlik	disability
xachir	mule
haqiqiy	actual
ilhomlantirdi	inspired
diplomlar	diplomas
xitob	appeal
ustoz	teacher
qurilish	construction
ikkilik	binary
diagrammasi	diagram
tikilgan	sewn
serverlari	servers
orqa	back
emitentlar	issuers
yopiq	closed
topografiya	topography
uyquda	asleep
belgilamoq	assess
tortishuv	argument
zoofiliya	zoophilia
qul	slave
kollagen	collagen
orasida	among
barqarorlik	sustainability
shaxmat	chess
tajovuz	aggression
shunday	thus
kapitalizm	capitalism
yangidan	afresh
sabablari	reasons
mitti	dwarf
mushkul	arduous
izlar	tracks
gapirmoqda	speaking
nur	shine
badiiy	artistic
payvandlash	welding
ingichka	thin
paragraf	paragraph
juftliklar	couples
tomizish	drip
hamkorlik	cooperation
tashabbuskor	initiator
arenalar	arenas
foydalanishga	handy
adenozin	adenosine
havoriy	apostle
kengaytirish	expansion
ishemik	ischemic
jannat	paradise
diafragma	diaphragm
kupon	coupon
diktator	dictator
oziqlangan	fed
siqish	squeeze
sharbat	juice
shoirlar	poets
ettinchi	seventh
kutilmagan	accidental
parchalanish	decay
kasbiylik	professionalism
yaylov	pasture
birodarlik	brotherhood
ishonchsiz	unreliable
masih	christ
bandargohlar	harbors
nominatsiyalar	nominations
operativ	operative
sportzal	gym
tunnellar	tunnels
depressiv	depressive
jinoyatchi	criminal
zoologiya	zoology
tamaki	tobacco
ularga	them
fiziologiya	physiology
jarroh	surgeon
xudo	god
baxt	happiness
mehr	affection
dolzarbligi	urgency
antibiotik	antibiotic
kelajak	future
noutbuk	laptop
shayx	sheikh
eslaydi	recalls
ekspert	adept
uels	welsh
azot	nitrogen
stomatologiya	dentistry
iflos	dirty
asos	base
etil	ethyl
joylashish	arrangement
bu	this
yotar	lay
guruhlash	grouping
onalar	mothers
faralar	headlights
ustida	over
serob	abundant
faraz	assumption
boshqa	other
episkop	bishop
sabotli	adamant
bokschilar	boxers
interfeys	interface
kalligrafiya	calligraphy
yoqtirmaslik	antipathy
qatnashish	attendance
arka	arc
oksidlanish	oxidation
rashkchi	jealous
radiatsiya	radiation
elektr	electric
issiqxonalar	greenhouses
yumshoq	gentle
okeanik	oceanic
albatta	course
imzolandi	signed
yetarli	enough
zerikarli	boring
shakar	sugar
yoy	arc
nazariyalar	theories
galda	agenda
ayniqsa	especially
vahimali	awful
karolina	carolina
sovun	soap
shubhali	doubtful
tutatqi	incense
ijtimoiy	social
ehtirosli	passionate
respondentlar	respondents
arab	arabic
rivojlangan	advanced
fan	science
uzatuvchi	transmitter
yangi	fresh
mamlakat	country
xiyonat	betrayal
tanlov	alternative
kasal	sick
sochiqlar	towels
badjahl	angry
faol	active
satr	row
jodugar	witch
zaharli	poisonous
konserva	canned
milya	miles
talablar	requirements
olqish	applause
kolbasa	sausage
raqobatchilar	competitors
ehson	donation
barlar	bars
baholash	evaluation
janjal	scandal
ofislari	offices
qidiruvchi	seeker
qutilar	boxes
termostat	thermostat
yarasha	according
ayblov	accusation
imkoniyatlar	opportunities
u	he
skandinaviya	scandinavia
gradus	degree
taqribiy	approximate
ruxsat	admission
projektorlar	projectors
diagrammalar	diagrams
gapiradi	speaks
qaerda	where
traktorlar	tractors
bosqinchilik	aggression
mezbonlar	hosts
xabardorlik	awareness
molekula	molecule
kunlar	days
fayllar	files
televizorlar	tvs
kategorik	categorical
burro	audible
fikr	mind
men	i
ohangdosh	consonant
orqasidan	across
endometrioz	endometriosis
almashinish	exchange
konchilik	mining
silikon	silicone
drenajlash	drainage
amerikaliklar	americans
jinoyatlar	offenses
sudraluvchi	reptile
shirinlik	sweetness
kamsitish	abasement
rekombinant	recombinant
yillik	annual
sendvich	sandwich
astronavt	astronaut
taqdiri	fate
oqim	stream
antropogen	anthropogenic
parazit	parasite
yondashuvlar	approaches
profillar	profiles
sharqiy	eastern
charchagan	tired
daraxtlar	trees
yirtqichlar	predators
rekord	record
fizioterapiya	physiotherapy
savodsizlik	ignorance
guruhlar	groups
jonlanish	animation
puxta	accurate
substratlar	substrates
kengligi	width
ritmik	rhythmic
improvizatsiya	improvisation
kiyish	wear
kulrang	ashy
buyruqlar	commands
kabellar	cables
baland	aloud
manfiy	minus
germetik	air-tight
avtomatlashtirilgan	automated
tasavvur	imagine
xavfsizroq	safer
tarixiy	historical
indoneziya	indonesian
ekinlar	crops
hisobotlar	reports
ilgari	ago
bahavo	airy
hakamlar	referees
guruch	rice
stabilizatsiya	stabilization
ismaloq	spinach
hunarmand	craftsman
beqaror	unstable
elastik	elastic
saxiy	generous
daromad	earnings
tamoyillar	principles
atmosfera	atmosphere
oyatlar	verses
tushirish	discharge
noyob	unique
trilogiya	trilogy
yirtilgan	torn
gvineya	guinea
yutuq	achievement
qahramonlar	heroes
pediatrik	pediatric
tushuncha	consciousness
tovoqlar	trays
lordlar	lords
vakil	attorney
shamollar	winds
birlashtirildi	merged
kast	caste
aeroport	airport
kasallik	illness
chunki	since
sayyoralar	planets
sahro	desert
serob	affluent
himoya	protect
kul	ash
modeli	model
misollar	examples
jamlama	compilation
ginekologiya	gynecology
takabburlik	arrogance
alkogolizm	alcoholism
besaranjomlik	ado
jiddiy	serious
mafiya	mafia
avto	auto
chamasi	approximately
mandat	mandate
radiologiya	radiology
muqaddam	ago
qituvchilarning	andy
repressiya	repression
tezis	thesis
antologiya	anthology
intervyu	interview
himoyasiz	vulnerable
tergovchilar	investigators
nok	pear
xizmatkor	attendant
eng	most
turkmaniston	turkmenistan
botanika	botany
yaqinlashdi	approached
aylanadi	turns
ishonish	assurance
raqamlash	numbering
ozon	ozone
qulaylik	accommodation
bank	bank
vals	waltz
sxema	chart
ichida	in
metalldan	metal
haqorat	insult
unutilmas	unforgettable
tasdiqlaydi	confirms
zarba	blow
majburiyat	commitment
investitsiyalar	investments
oson	easy
shuningdek	also
kaskad	cascading
mix	mix
germanlar	germans
shikastlanishlar	injuries
shveytsariya	swiss
xavfli	dangerous
kamsituvchi	discriminatory
kanton	canton
jinslar	rocks
prezentatsiyalar	presentations
generatorlar	generators
hovuzlar	pools
kaft	palm
arifmetika	arithmetic
chiptalar	tickets
afyun	opium
klaviatura	keyboard
muhandislik	engineering
kuchaytirmoq	accelerate
sayt	site
raqqosa	dancer
apelsin	orange
ochlik	hunger
oila	family
sichqoncha	mouse
maqolalar	articles
tark	leave
sharhlovchilar	commentators
qaroqchilik	piracy
nutq	speech
notekis	uneven
jozibasi	charm
tozalovchi	cleaner
bilimdon	adept
vokal	vocals
atlas	atlas
kimdir	anyone
liberalizm	liberalism
marosimi	ceremony
tezlashtiruvchi	accelerator
feminizm	feminism
remissiya	remission
maqsadli	targeted
tirsak	elbow
noqulay	austere
doira	ambience
yozuvchilar	writers
qoliplari	molds
bulutli	cloudy
ergashuvchi	adherent
sabzavotlar	vegetables
kiyim	apparel
yozuvlar	records
antropologiya	anthropology
algoritmlar	algorithms
keyinchalik	afterwards
burgut	eagle
norma	norm
amplituda	amplitude
yem	feed
afrikalik	african
tribunallar	tribunals
bazasi	base
manmanlik	assurance
qoldiq	residue
onalik	motherhood
akademiya	academy
sitokin	cytokine
stadionlar	stadiums
yuz	hundred
sarsabil	asparagus
baqlajon	aubergine
ahamiyat	attention
animatsiya	animation
aralashmalar	mixtures
universitet	university
yostiq	pillow
yugurib	ran
kosmologiya	cosmology
stajer	trainee
kauchuk	rubber
steril	sterile
hafta	week
shaffof	transparent
hamkor	partner
nurlari	rays
polimorfizm	polymorphism
element	element
demokrat	democrat
gigantlar	giants
fiziklar	physicists
quyosh	sun
donalab	apiece
kranlar	cranes
membranalar	membranes
tushunish	apprehension
isyonchi	rebel
xiyobon	alley
ota-onalar	parents
harakatchan	assiduous
burun	nose
tasodif	accident
atomlari	atoms
anonimlik	anonymity
salatlar	salads
vakolat	authority
qurolsizlanish	disarmament
tirsaklar	elbows
sportchilar	athletes
farishta	angel
anglatadi	meant
gul	flower
suv	water
kamon	bow
antilopa	antelope
asosiy	actual
termometr	thermometer
injil	bible
oldinga	along
qilich	sword
sabotaj	sabotage
paradoks	paradox
sitrat	citrate
yomon	adverse
savdo	trade
diktator	autocrat
insoniyat	humanity
determinantlar	determinants
ishonchliligi	reliability
kafe	cafe
muxbir	correspondent
beton	concrete
shakllar	forms
interfeyslar	interfaces
hisoblangan	calculated
qoshlar	eyebrows
ixtiro	invention
farqlar	differences
klip	clip
shuhratparast	ambitious
meva	fruit
normativ	normative
yuqorida	above
qarama-qarshi	opposite
sotib	bought
fohishalar	prostitutes
ulush	share
qabriston	cemetery
dizel	diesel
manzillari	addresses
xotin	wife
xromosomalar	chromosomes
eshittirishlar	broadcasts
johil	ignorant
amaki	uncle
alohida	separate
chegaralamoq	abridge
ibodatxonalar	temples
narxlar	prices
aksessuarlar	accessories
yetti	seven
velosiped	bicycle
oqlash	justification
koronar	coronary
beqarorlik	instability
olib	bring
zulmat	darkness
taassurot	impression
rais	chairman
imzosi	signature
kompensatsiya	compensation
radikal	radical
koordinator	coordinator
undalma	apostrophe
jahl	anger
narvon	ladder
iqlimi	climate
ishtirokchilar	attendance
hushtak	whistle
epchil	agile
admiral	admiral
bouling	bowling
xavfli	danger
respublika	republican
suhbatlashdi	talked
emulsiya	emulsion
litr	liter
vazifalari	functions
dinozavrlar	dinosaurs
diplomatik	diplomatic
xunuk	atrocious
ixtiyoriy	optional
ildiz	root
uquvsiz	awkward
qadoqlangan	packed
tobut	coffin
tushishi	fall
mavsumiy	seasonal
gipnoz	hypnosis
ulkan	huge
mohirlik	art
taxalluslar	aliases
forumi	forum
sionistik	zionist
beshta	five
yaradorlar	wounded
yana	again
informatika	informatics
hamma	all
birlashma	unification
ustalar	masters
kazinolar	casinos
erishmoq	acquire
darvoza	gate
ruminiya	romania
ayollar	women
vabo	plague
ajablanarli	surprising
oldingi	antecedent
harorati	temperature
uni	him
ovlangan	hunted
moyillik	inclination
kengashlar	councils
fabrikalar	factories
vazn	weight
tanaffus	break
keskin	acute
jarima	fine
baland	high
hayratlanarli	admirable
salat	salad
ovozi	sound
alyuminiy	aluminum
maslahatchi	counselor
shafqatsiz	ruthless
qiya	ajar
bodom	almond
faollashtirish	activate
immunizatsiya	immunization
akvariumlar	aquariums
arxaik	archaic
peptid	peptide
litsenziya	license
dars	lesson
vakolatli	competent
opa-singillar	sisters
dispetcher	dispatcher
mikroskoplar	microscopes
emizish	breastfeeding
tirilish	resurrection
granulalar	granules
norozilik	dissatisfaction
balandlik	altitude
rivojlanish	advance
nufuzli	prestigious
chayonlar	scorpions
chap	left
u	she
belgilash	assignment
bino	apartment
notinch	anxious
pigmentlar	pigments
karl	carl
qurolli	armed
taxlika	alarm
loyiq	worthy
donolik	wisdom
maxfiylik	confidentiality
vikipediya	wikipedia
yoqtirmaslik	dislike
shol	apoplexy
jonli	live
sherlar	lions
dada	dad
kashfiyotchi	inventor
reaktor	reactor
sarguzasht	adventure
konstitutsiyaviy	constitutional
chuqurlik	depth
aeroportlar	airports
akatsiya	acacia
sim	wire
yaxshi	good
stullar	chairs
klon	clone
tikuvchi	tailor
uzluksiz	abiding
muhandis	engineer
logistika	logistics
qurol	gun
ona	mother
rang	color
malakasi	qualification
hovlilar	yards
silliqlash	grinding
payshanba	thursday
buyurtmalar	orders
asbob	instrument
geografik	geographical
tillar	languages
aborigen	aborigine
xachir	ass
misol	example
oz	few
mehnat	labor
tayinlash	appointment
marvaridlar	pearls
pashsha	fly
ishtirokchi	participant
kinoteatrlar	cinemas
savdogar	trader
stomatolog	dentist
samolyot	plane
xursandchilik	joy
garchi	though
etim	orphan
boshqarma	administration
karvonlar	caravans
chizish	draw
yil	year
asimptotik	asymptotic
diplom	diploma
dizayner	designer
tanish	familiar
asosiy	main
raqam	number
sevgilisi	lover
kuzatadi	observes
interyerlar	interiors
kredit	credit
immigrantlar	immigrants
murakkabligi	complexity
xodimlar	employees
hamkasblar	colleagues
isitgichlar	heaters
segment	segment
zaiflik	vulnerability
kodeklari	codecs
tenglama	equation
statistik	statistical
ultratovush	ultrasound
kechirildi	forgiven
ustun	column
malakali	qualified
arxitektura	architecture
psixoterapiya	psychotherapy
hujumchi	striker
sharbatlar	juices
teshik	aperture
nisbatlar	proportions
shifrlash	encryption
qorin	abdomen
sistein	cysteine
qumtosh	sandstone
eshitadi	hears
vakuum	vacuum
laureat	laureate
yorliqlar	shortcuts
tuzatmoq	ameliorate
mobilizatsiya	mobilization
oldidagi	antecedent
fermerlar	farmers
kutubxonachi	librarian
uslubi	style
pivo	beer
afrika	africa
sakkizta	eight
qutblar	poles
ustalik	art
sanktsiyalar	sanctions
bayroq	flag
isyonchilar	rebels
asl	authentic
voqeani	anime
yuborish	sending
proksimal	proximal
vasiyat	testament
birlashma	association
elka	shoulder
bilimdon	aware
ametist	amethyst
teri	skin
bazi	some
avval	ago
kurslar	courses
shevasida	polish
vajohat	air
antenna	aerial
fikrlash	thinking
kostyum	suit
ota	father
manzili	address
ignalar	needles
arzon	cheap
aziz	dear
maslahatchi	adviser
aytish	say
xonalar	rooms
tashxis	diagnosis
begonalar	strangers
biosfera	biosphere
terminallar	terminals
yer	soil
parol	password
umid	hope
kvartira	apartment
orol	island
gramm	gram
kateter	catheter
zanglamas	stainless
uyalar	slots
karnaval	carnival
daho	genius
ahamiyatsiz	insignificant
mudofaa	defense
appenditsit	appendicitis
byudjet	budget
atrofida	around
rasm	picture
yorliq	shortcut
vatt	watt
ohanglar	tones
miltiq	rifle
bardoshli	durable
sayoz	shallow
toza	clean
siyosatchi	politician
muhokama	discuss
indekslari	indices
buddizm	buddhism
fakultetlar	faculties
burun	ago
rafiqa	wife
egallash	acquisition
guruhlangan	grouped
tashkilot	organization
qisqartirmoq	abbreviate
tekis	flat
chastota	frequency
kafolati	warranty
tashabbus	initiative
intellektual	intellectual
madaniyat	culture
qurollantirmoq	arm
gimnastika	gymnastics
kotibi	secretary
ittifoqdosh	ally
fotometriya	photometry
mashhurlar	celebrities
tufli	shoe
kuz	autumn
suverenitet	sovereignty
hamkorlar	partners
semestr	semester
odat	approach
emlash	vaccine
klapanlar	valves
orasida	between
ishqalanish	rubbing
musiqachi	musician
quv	astute
ranjish	affliction
ekskursiya	excursion
geologiya	geology
elementar	elemental
qamoqxona	prison
astronavt	astronaut
soat	hours
janoblar	gentlemen
mahalliylashtirish	localization
kitoblar	books
muhim	major
gil	clay
birlik	unity
ananas	pineapple
federatsiya	federation
umumlashma	generalization
vakillari	representatives
zargar	jeweler
allergiya	allergy
rasmiy	official
shakllanishi	formation
chiziq	line
tamomila	absolutely
olmos	diamond
versiyalari	versions
vositachi	arbitrator
unutildi	forgotten
lablar	lips
tijorat	commerce
suyaklar	bones
oltinchi	sixth
qiziqish	interest
globallashuv	globalization
ekvivalentlik	equivalence
tajriba	experiment
homila	fetus
ovqat	food
kichkina	tiny
murojaat	address
nomzod	applicant
zararkunandalar	pests
million	million
moduli	module
usul	method
talab	demand
avlodlar	generations
tasdiqladi	confirmed
aralashuv	interference
yoki	whether
sovigan	cooled
elektrlashtirilgan	electrified
derivatsiya	derivation
qalinligi	thickness
yakka	single
maslahatchilar	consultants
aviatsiya	aviation
vakil	delegate
gormonal	hormonal
chaqqon	agile
makon	abode
rayonlashtirish	zoning
plaginlari	plugins
kanal	channel
avtobuslar	buses
vandalizm	vandalism
teshiklari	holes
tahdidlar	threats
komp	comp
optimistik	optimistic
saylovchilar	voters
rektal	rectal
antonim	antonym
kirdi	entered
gollandiya	netherlands
immunitet	antibody
zarur	necessary
biroz	some
tahqirlash	humiliation
tobe	ancillary
impulslar	impulses
menejeri	manager
egalari	owners
nomlash	naming
sher	lion
iliq	warm
xazinachi	treasurer
ammiak	ammonia
qoniqarsiz	unsatisfactory
bar	bar
achinarli	abject
sariq	yellow
planshetlar	tablets
bitim	agreement
suvda	afloat
matn	text
kriptografiya	cryptography
biotexnologiya	biotechnology
parashyut	parachute
lotereyalar	lotteries
kongress	congress
materiallar	materials
chidamli	able-bodied
ehtiroslar	passions
odatda	usually
nol	zero
mustamlaka	colony
tavsiflovchi	descriptive
kolorado	colorado
astma	asthma
kuzatuvlar	observations
ish	action
fitna	conspiracy
xlor	chlorine
yutmoq	swallow
zallari	halls
sadoqat	allegiance
yutish	swallowing
terroristlar	terrorists
kategoriyalari	categories
bor	had
xlorid	chloride
siljishlar	shifts
kislorod	oxygen
konservativ	conservative
havo	air
kristall	crystal
algebra	algebra
monoxrom	monochrome
tasodif	coincidence
moslashuvchanlik	flexibility
qidiruvchilar	seekers
sarflash	spend
tajovuzkor	aggressive
chegarasi	boundary
ertaga	tomorrow
soya	soybean
alibi	alibi
ajralish	divorce
klinikalar	clinics
tizim	system
bakalavr	bachelor
mukammallik	perfection
nafaqa	spend
tebranish	vibration
tushuntiradi	explains
pornografik	pornographic
printsipi	principle
bolalar	children
nometall	mirrors
sovuq	cold
turbulentlik	turbulence
lotin	derivative
ravish	adverb
reaktivlik	reactivity
ustunlar	columns
orqaga	aback
oqlangan	elegant
prefikslar	prefixes
yonoq	cheek
vakil	agent
keshlash	caching
yozildi	typed
lazerlar	lasers
nasroniylik	christianity
tili	language
belgilar	characters
infiltratsiya	infiltration
kompilyatorlar	compilers
psixiatr	psychiatrist
nayrangbozlik	antics
mayl	affection
fuqaro	citizen
pasport	passport
qoshiq	spoon
vaziyatlar	situations
ijodkorlik	creativity
bajarish	carry
mototsikl	motorcycle
litsenziyalash	licensing
hatto	even
amerika	america
tetiklantiruvchi	refreshing
aktivator	activator
mamont	mammoth
bezatish	decoration
sharaf	honor
metodikasi	methodology
xudolar	gods
sezgir	alert
betaraflik	neutrality
maymunlar	monkeys
chirigan	rotten
chiqish	ascent
artrit	arthritis
ishtiyoq	aspiration
yoritish	lighting
qarish	aging
meksika	mexico
jigarrang	brown
gormon	hormone
tahlil	assay
qolish	stay
aniq	apparent
musulmon	muslim
metamfetamin	methamphetamine
otish	throw
imkoniyatlari	options
harakat	motion
osiyoliklar	asians
tatuirovka	tattoos
plazma	plasma
yozish	write
his	feel
keskin	abrupt
muammo	problem
jamiyatlar	societies
simonlar	simons
tirik	alive
familiyalar	surnames
tilim	slice
usti	top
yutuq	acquisition
karam	cabbage
ortadi	increases
shoxlari	horns
maqola	article
shubhalar	doubts
tamomila	absolute
donalar	grains
aerodrom	airfield
yakunlangan	accomplished
qonun	law
qazish	digging
xronologiya	chronology
elchilar	ambassadors
tutashtiruvchi	adjacent
tromboz	thrombosis
mehribon	affectionate
ifloslanish	pollution
geofizik	geophysical
erta	early
egizaklar	twins
snayper	sniper
tuzatish	correction
limon	lemon
laboratoriyalar	laboratories
dramatik	dramatic
omadli	lucky
kosmik	cosmic
ishtirokchilar	participants
loyqalik	blur
javob	response
dekabr	december
kamaytirish	reduce
buddist	buddhist
stipendiya	allowance
boy	rich
ayol	woman
faollashtirilgan	activated
taqvim	almanac
sozlamoq	amend
davomat	attendance
tilanchilik	begging
yaroqsiz	invalid
mushuklar	cats
xola	aunt
aralashdi	confused
bizlar	we
kengroq	broader
kengaytirildi	expanded
omil	factor
oxiri	end
iqtisodchi	economist
tayyorlangan	prepared
oq	white
magnit	magnet
terapevtik	therapeutic
ilohiylik	divinity
jarlik	cliff
xushchaqchaq	airy
kontekstli	contextual
bankrotlik	bankruptcy
deklaratsiya	declaration
oyoq	foot
qatnashmaslik	absence
metafora	metaphor
tozalash	cleaning
beparvolik	apathy
meniki	mine
ayyor	astute
krater	crater
viruslar	viruses
orqali	through
tetik	alert
peru	peruvian
diqqat	attention
ring	ring
banan	banana
shakl	figure
qodir	capable
dangasa	lazy
dovdir	addle
bazal	basal
qayin	birch
quyruq	tail
yoqa	collar
okeanografiya	oceanography
kiyik	deer
chiroyli	beautiful
korrelyatsiya	correlation
yuza	surface
qanot	wing
olovda	ablaze
sotsialistik	socialist
virusli	viral
chiroq	lamp
xitlar	hits
jek	jack
egasi	owner
sportchi	athlete
yordamchi	assistant
dahshatlar	horrors
temir	iron
quvurlar	pipes
harakat	act
jihozlangan	equipped
kafel	tile
quyon	rabbit
joylashtirish	placement
klassik	classic
kartalar	cards
murojaat	application
formatlari	formats
quvvat	power
sof	pure
chumolilar	ants
hikoya	story
remixlar	remixes
sud	court
cherkovlar	churches
piyoz	onion
kuchlar	forces
nazariya	theory
bizning	ours
oniks	onyx
yodgorlik	monument
ularning	their
oy	moon
murakkab	complicated
tuxum	egg
mayoq	beacon
tizimlar	systems
ulanishlar	connections
nikohlar	marriages
keraksiz	unnecessary
shokolad	chocolate
qisqacha	briefly
quv	artful
kontur	contour
bozor	market
aka	brother
kuchli	almighty
shimol	north
konstruktiv	constructive
chekuvchi	smoker
plaj	beach
shifrlangan	encrypted
tomografiya	tomography
pedallar	pedals
nekroz	necrosis
imkoniyat	opportunity
sahifa	page
farazlar	hypotheses
taqqoslashlar	comparisons
achchiq	bitter
kontrasti	contrast
oldinga	forward
natijalar	results
ovozlar	voices
zelandiya	zealand
ichak	intestine
standartlar	standards
tushuntirish	explanation
uglerod	carbon
xizmatkorlar	servants
qoralash	strike
texnolog	technologist
filmlar	movies
va	and
pushti	pink
harakat	activity
hamma	all
tonik	tonic
rioya	follow
boshlovchi	announcer
soliq	arrears
ruxsat	allow
tranzistor	transistor
kiriting	enter
zangori	azure
munosib	adequate
ayblash	charge
ittifoq	alliance
qizlar	girls
quradi	builds
koreyscha	korean
lokomotivlar	locomotives
belgilamoq	appoint
osilgan	hanging
pishirilgan	cooked
shohlar	kings
tezaurus	thesaurus
belgiyalik	belgian
hovli	courtyard
serblar	serbs
hunar	art
rangi	color
tovuqlar	chickens
zonalari	zones
tushunchasi	concept
soyalar	shadows
shizofreniya	schizophrenia
ajratmoq	allot
dala	field
farq	differ
franchayzing	franchising
chora	antidote
kasblar	occupations
olomon	crowded
kabutarlar	pigeons
tergov	investigation
venoz	venous
tibbiyot	medicine
qizil	red
falaj	apoplexy
buzib	broke
vulkanlar	volcanoes
sehrgarlar	wizards
elastiklik	elasticity
haqiqiy	true
saraton	cancer
mashhurlik	popularity
siklonlar	cyclones
uning	her
hukumat	government
qodir	almighty
ketgan	gone
bet	page
muovin	assistant
ilgaklar	hooks
ruslar	russians
antifriz	antifreeze
arifmetik	arithmetic
tez-tez	frequently
olov	fire
ziyolilar	intellectuals
monitorlar	monitors
dush	shower
minnatdor	grateful
kobalt	cobalt
velosipedchilar	cyclists
hodisa	event
qoziqlar	piles
uzoqdagi	distant
urinish	try
tepasida	above
basist	bassist
tenderlar	tenders
neytrino	neutrino
yuvilgan	washed
tsenzura	censorship
egar	saddle
koeffitsientlar	coefficients
chodirlar	tents
misrlik	egyptian
kuba	cuba
porlashi	shining
mustamlakachi	imperialist
ushlangan	caught
pulpa	pulp
quduqlar	wells
islomiy	islamic
dengizchilar	sailors
qosh	eyebrow
akademiklar	academics
voleybol	volleyball
mikroelektronika	microelectronics
chegaradosh	bordering
xamirturush	yeast
yanglish	amiss
mavzular	themes
dollar	dollar
uyushma	association
muhim	actual
etiologiya	etiology
markazlari	centers
berahmlik	atrocity
hippi	hippie
muvofiq	admissible
er-xotin	couple
tortishuvlar	controversy
majmui	aggregate
qadimgi	old
kalit	key
karb	carb
qarindoshlar	relatives
belgi	sign
foydali	available
hayot	life
koloniyalar	colonies
yetuklik	maturity
takrorlaydi	repeats
tashvishlar	concerns
muqaddaslik	holiness
pestitsidlar	pesticides
fojialar	tragedies
analitik	analytical
astma	asthma
uch	apex
amaliy	practical
oldida	ahead
hamshiralar	nurses
diniy	religious
qalinroq	thicker
doiralar	circles
neyron	neuron
hakam	referee
ramka	frame
biografik	biographical
boyitilgan	enriched
chidamli	resistant
albancha	albanian
kvadrant	quadrant
luqma	bite
yumush	affair
immigratsiya	immigration
bola	child
qahr	anger
boshqarildi	managed
chegirma	discount
tinglash	listen
repressiv	repressive
boshladi	began
chempionat	championship
uchta	three
natija	aftermath
zanjirlar	chains
brauzer	browser
qiyin	hard
shayton	devil
olib	brought
orqadan	aback
direktiv	directive
depozitariy	depository
kompyuterlar	computers
tarjimon	translator
mumkin	possible
poni	pony
maslahatlar	tips
mahsulotlar	products
ulashgan	adjacent
xaotik	chaotic
dinozavr	dinosaur
koks	coke
toksinlar	toxins
front	front
shunday	so
standartlari	standards
astrologiya	astrology
texnologlar	technologists
jazoladi	punished
burilish	turning
prospekt	avenue
chayon	scorpion
asoschisi	founder
xokkey	hockey
makedoniyalik	macedonian
duradgor	carpenter
fartuk	apron
auditorlar	auditors
tadbirkor	entrepreneur
akustik	acoustic
prototip	prototype
krem	cream
isbot	argument
hasharotlar	insects
fantaziya	fantasy
mikrofonlar	microphones
toksin	toxin
oldin	ago
barabanchi	drummer
baholash	assessment
terapiya	therapy
kamtarinlik	humility
ilon	snake
sintez	synthesis
daqiqa	minute
shaxslar	individuals
muammolar	problems
ehtiyotkor	assiduous
aksioma	axiom
rivojlanish	development
muvofiq	adequate
oksford	oxford
nomlari	names
olqishlamoq	acclaim
silindrsimon	cylindrical
vatanparvarlik	patriotism
iltimos	wish
aholining	populate
ijodiy	creative
klonlash	cloning
buyraklar	kidneys
aytmoq	tell
xristianlik	christianity
yumaloq	round
birinchi	first
musson	monsoon
koalitsiyalar	coalitions
mushaklar	muscles
mumkin	may
yoriq	aperture
qatnashuvchilar	attendance
galstuk	tie
diskografiya	discography
qurilma	device
avtobus	bus
stipendiyalar	scholarships
taksi	taxi
tishlar	teeth
bambukdan	bamboo
shishalar	bottles
taxta	board
xarajat	cost
foydasiz	useless
tanlaydi	selects
tarmoqlar	networks
sayyoh	tourist
butlar	idols
egizak	twin
eniga	across
tuya	camel
kurtaklari	buds
mikrofilm	microfilm
qirralarning	edges
kvartet	quartet
ovchilik	hunting
segmentatsiya	segmentation
polinom	polynomial
skript	script
konfiguratsiya	configuration
jinoyatchilar	criminals
terrorizm	terrorism
belgi	mark
nazar	look
axloq	morality
kema	ship
visseral	visceral
regulyator	regulator
bari	both
poezd	train
astronomlar	astronomers
bannerlar	banners
tenglamalar	equations
xristianlar	christians
daryo	river
keng	wide
tasnifi	classification
taqqoslash	comparison
jarohati	injury
turizm	tourism
soha	area
katalitik	catalytic
qurbaqa	frog
rejalashtirilgan	planned
qudratli	almighty
filtrlash	filtering
komediyachi	comedian
chet	edge
aniqlamoq	appoint
olmoq	make
gunohlar	sins
akt	act
qurtlarni	worms
ekspluatatsiya	exploitation
saqlamoq	keep
varaq	sheet
avtoritar	authoritarian
kanadaliklar	canadians
zona	zone
astronomik	astronomical
tuman	district
eshiklar	doors
armiya	army
ajdod	ancestor
kutilmagan	sudden
sinov	test
ishonch	sure
muassasa	institution
margarin	margarine
mozaika	mosaic
tashriflar	visits
kompozitor	composer
pishloq	cheese
tanlovlar	contests
klasterlar	clusters
kabriolet	cabriolet
vazirliklar	ministries
muzokara	negotiation
nimadir	anything
asosan	mainly
sodiqlik	loyalty
siyosat	politics
ixtirochilar	inventors
spektroskopiya	spectroscopy
chuqurlashtirish	deepen
tasdiqlanish	assertion
ehtiros	passion
yoritilgan	illuminated
qurollar	arms
angliya	anglo
multfilm	cartoon
xabarnoma	notification
taxminiy	approximate
kaliforniya	california
kobra	cobra
prolin	proline
kliplar	clips
gipofiz	pituitary
ortiqlik	advantage
alfa	alpha
portretlar	portraits
tahlil	analysis
maska	mask
tashabbuslar	initiatives
kofirlik	atheism
xijolatli	abashed
chorak	quarter
befarq	indifferent
yubiley	jubilee
poytaxt	capital
nima	what
biometrik	biometric
mushk	musk
ichki	inner
uchrashuv	meeting
odam	man
dengiz	sea
beshik	cradle
travma	trauma
filiali	branch
katolik	catholic
parodiya	parody
ezish	crush
daromadlar	revenues
shisha	bottle
kub	cube
aylantirish	convert
davomida	during
foton	photon
gorizontal	horizontal
yosh	young
tolasi	fiber
senariy	scenario
hosil	crop
kombinatsiyalar	combinations
sportchi	athlete
maktablar	schools
turk	turkish
luqma	allusion
savodxonlik	literacy
ziyrak	attentive
yahudiylar	jews
majoziy	figurative
bilimdon	knowledgeable
paxta	cotton
tashviqot	agitation
hushyor	alert
maydon	space
namunali	exemplary
progesteron	progesterone
nasosi	pump
aniqlash	determination
keyingi	another
gunohkorlar	sinners
tashvish	anxiety
sukunat	ease
gapirish	talk
maqsad	ambition
muallif	author
triatlon	triathlon
takrorlash	repeat
diplomat	ambassador
yuvish	wash
begona	alien
farmon	decree
yuqori	high
qarama-qarshiliklar	contradictions
kursiv	italic
vagon	wagon
dekoder	decoder
konsullik	consulate
sut	milk
suzmoq	swim
jurnalistik	journalistic
tezroq	faster
yigirma	twenty
butunlay	altogether
oqimlari	currents
kompyuter	computer
kashfiyotlar	discoveries
boshqa	another
astrofizika	astrophysics
garnizon	garrison
tajovuzkor	offensive
idoraviy	departmental
nuqta	point
oshirmoq	aggrandize
yaralar	wounds
kotib	secretary
vokalchi	vocalist
xabarchilar	messengers
hakam	arbitrator
artist	actor
kationlar	cations
doimo	always
telegraf	telegraph
tuklar	feather
deputatlar	deputies
anatomiya	anatomy
davlatlararo	interstate
umumiy	common
geografiya	geography
gacha	until
reklamalar	ads
jonlantirilgan	animated
murabbiy	coach
qushlar	birds
omborlar	warehouses
akvarium	aquarium
kampus	campus
konvoy	convoy
yangiliklar	news
satira	satire
ovozli	sound
itoatkorlik	obedience
ilova	additional
kompas	compass
sotuvchilar	sellers
takrorlangan	repeated
eskirgan	outdated
munosib	according
saylovlar	election
oyoqlari	legs
turklar	turks
atmosfera	ambience
fikr	angle
choksiz	seamless
juft	pair
imperiyalar	empires
solishtiring	compare
tajovuz	aggression
boshqatdan	anew
kivi	kiwi
kerakli	available
tik	steep
xarajatlar	expenses
profil	profile
kampaniyasi	campaign
ayiq	bear
tayinlash	assignment
qalbaki	artificial
arxeologiya	archaeology
kirillcha	cyrillic
gazlar	gases
tarmoqli	tape
ideallar	ideals
kapitalistik	capitalist
komanda	team
kemiruvchilar	rodents
penetrasyon	penetration
detektorlar	detectors
namoyishlar	demonstrations
agentlik	agency
sandon	anvil
ekspeditsiya	expedition
mahallalar	neighborhoods
vosita	appliance
tellurid	telluride
bostirildi	suppressed
molekulalar	molecules
eman	oak
yaratuvchilari	creators
umidsiz	desperate
autizm	autism
konsentrlangan	concentrated
gardish	flange
yot	yacht
ark	arch
yoritgichlar	lamps
davom	continue
inkubator	incubator
buferlar	buffers
tirik	alive
sinonim	synonym
vampirlar	vampires
siyosiy	political
davr	age
poli	poly
qiladi	does
omonatlar	deposits
boshoq	spike
sarlavhalar	headings
hujjatlar	documents
ogohlantirishlar	warnings
konservatizm	conservatism
parcha	abstract
familiya	surname
mintaqaviy	regional
bokira	virgin
tomirlar	veins
xursand	glad
ratsion	ration
nomutanosib	disproportionate
tanishuv	acquaintance
niyat	intention
domen	domain
estoncha	estonian
yaratish	create
ekzema	eczema
mehmonlar	guests
tabiiy	natural
jihoz	appliance
tarix	history
bankrot	bankrupt
birga	together
korset	corset
qubba	arch
ilovalar	applications
yolvorish	pleading
markaziy	central
farqlash	differentiation
zerikish	boredom
tayyorlash	prepare
ochko	ace
antagonistlar	antagonists
zirhli	armored
tuproq	earth
erotik	erotic
modulyatsiya	modulation
kiruvchi	unwanted
halol	honest
pichoqlar	knives
ittifoqchilar	allies
bulardi	would
tepada	above
burchak	angle
ibtidoiy	primitive
ovqatlar	foods
fenotip	phenotype
dissertatsiyasi	dissertation
kodlash	coding
kuydirgi	anthrax
akril	acrylic
tashkiliy	organizational
futbolchilar	players
organik	organic
eshitib	heard
shartlar	conditions
ketdi	went
mening	my
kislota	acid
mutaxassislik	specialization
tahqir	affront
estetik	aesthetic
xalqaro	international
ekosistemalar	ecosystems
kamera	camera
yoqimtoy	adorable
orbitalari	orbits
deklaratsiyalar	declarations
xilma-xillik	diversity
pankreatik	pancreatic
asoratlar	complications
delegatsiya	delegation
grantlar	grants
atom	atom
iligi	marrow
provayderlar	providers
yunon	greek
tezislar	theses
agregatlar	aggregates
ajoyib	auspicious
ish	act
qabariq	bubble
imtihon	exam
organizmlar	organisms
fraktal	fractal
tabiat	nature
kimyo	chemistry
tiqilishi	congestion
onkologiya	oncology
qonli	bloody
strategiyalar	strategies
barmen	bartender
sayyohlar	tourists
veterinariya	veterinary
sarflaydi	spends
rojdestvo	christmas
rozilik	accord
bildirmoq	announce
kataloniya	catalonia
matonatli	adamant
beysbol	baseball
yana	again
optik	optical
hayotiy	vital
qiyinchilik	difficulty
tugallandi	completed
salqin	cool
katalizatorlar	catalysts
adresat	addressee
alifbo	alphabet
sayohatchilar	travelers
laktoza	lactose
glutamin	glutamine
anoyi	artless
modifikatorlar	modifiers
box	box
sifat	quality
maftunkor	charming
uy-joy	abode
institut	institute
garchi	although
jakob	jacob
tutunli	smoky
tahlil	analysis
vino	wine
qovurilgan	roasted
kompyuterlashtirilgan	computerized
uyatchan	ashamed
oqibatida	afterwards
isbotlamoq	attest
nomi	name
tomosha	watch
avtomatlashtirish	automation
chalkash	addle
studiya	studio
jingalak	curly
chaqirmoq	appeal
avstriya	austrian
bilan	with
tasdiqlash	approval
nordon	sour
keyingi	next
foydalanilmagan	unused
musobaqa	competition
litsenziyalar	licenses
tevaragida	around
chetda	away
keyinroq	later
basketbol	basketball
aniq	clear
deyarli	almost
yaxshiroq	better
malayziya	malaysia
grand	grand
mualliflar	authors
oqibat	aftermath
avstraliya	australia
zamonaviylik	modernity
mitinglar	rallies
irqchilik	racism
tarixchilar	historians
monoklonal	monoclonal
qiymati	value
albom	album
arvohlar	ghosts
efiopiyalik	ethiopian
quloq	ear
ritmlar	rhythms
autentifikatsiya	authentication
pastki	bottom
eksport	export
zal	auditorium
jarayon	process
masofalar	distances
otalar	fathers
ortogonal	orthogonal
bobosi	grandfather
almashuvlar	exchanges
imtiyoz	advantage
arabcha	arabic
anemiya	anemia
osteoporoz	osteoporosis
non	bread
transkripsiya	transcription
hissiyot	emotion
maqola	article
oziqlanish	nutrition
kublar	cubes
sakkizoyoq	octopus
arqon	rope
munozarasi	discussion
tahrir	edit
sifati	quality
jangarilar	militants
papa	pope
silliq	smooth
mikrob	germ
litsenziyalangan	licensed
okeanlar	oceans
sevgi	affection
qarang	see
reydlar	raids
dushmanlik	animosity
folklor	folklore
uyushmalari	unions
oy	month
behushlik	anesthesia
istiqbolli	promising
tuzilmalar	structures
jozibali	admirable
tarafdor	adherent
tashviqotchi	agitator
oftalmologiya	ophthalmology
bor	has
donorlar	donors
gipertenziya	hypertension
fermalar	farms
cheklangan	limited
choy	tea
dono	wise
isitma	fever
dumaloq	round
boshqarmoq	govern
sabab	reason
komplekslar	complexes
aqlli	smart
yangilandi	updated
akademik	academic
boshq	arc
tovus	peacock
amma	aunt
nikel	nickel
frans	band
shoshilinch	urgent
mos	applicable
murabbiylar	coaches
edi	were
ionlari	ions
notarius	notary
arktika	arctic
farq	difference
toksikologiya	toxicology
lipidlar	lipids
baronessa	baroness
astronomiya	astronomy
dialekt	dialect
psixiatrlar	psychiatrists
moviy	azure
diplomatiya	diplomacy
falsafa	philosophy
asoslangan	based
kollaj	collage
artikl	article
hijob	peat
katod	cathode
uddaburon	agile
ish	assignment
garov	pledge
tamoman	all
dushanba	monday
sigir	cow
asos	basis
meksikalik	mexican
iqtisodiy	economical
ruxsatsiz	unauthorized
buloqlar	springs
kiyimlar	clothes
avans	advance
bola	boy
ishchilar	workers
joriy	current
himoyalangan	protected
eliksir	elixir
jurnalistlar	journalists
arena	arena
aslaha	armament
ishonch	trust
qush	bird
abort	abortion
farmakologiya	pharmacology
chekish	smoking
pichoq	knife
fahmlash	apprehension
takroran	again
qorli	snowy
mart	march
koma	coma
aviabaza	air-base
suyuqlik	fluid
elliptik	elliptical
fillar	elephants
organ	organ
realistik	realistic
qozon	win
kamqonlik	anaemia
kompost	compost
tengdir	equals
zaiflashgan	weakened
aktrisa	actress
singan	broken
nazorat	check
sanoq	account
muddatsiz	indefinitely
erishish	reach
primatlar	primates
stavkalar	rates
katoliklar	catholics
transplantatsiya	transplantation
sinchkov	assiduous
ilm-fan	science
sarmoya	investment
taroqsimon	comb
asoslari	basics
ish	affair
dinamo	dynamo
zohid	ascetic
jismonan	physically
anesteziya	anaesthesia
kichikroq	smaller
uchburchaklar	triangles
aktivlar	assets
radioaktiv	radioactive
qoya	rock
yana	another
sotuvchi	vendor
baholash	appreciation
odobsiz	obscene
andozalar	templates
baxtsizlik	misery
okinava	okinawa
kamar	belt
post	post
sezgi	intuition
baholandi	rated
maydon	field
tentak	ass
havaskorlar	amateurs
lagerlar	camps
modellashtirish	modeling
epidemiologiya	epidemiology
kelgan	came
kriptografik	cryptographic
foydalanuvchilar	users
qirq	forty
ohang	tone
ruxsat	permission
xayoliy	imaginary
gaz	gas
bitirmoq	accomplish
sirop	syrup
perkussiya	percussion
kategoriya	category
armiya	army
baholamoq	assess
akr	acre
uzluksiz	uninterrupted
raqib	opponent
yozishmalar	correspondence
qabr	grave
plastik	plastic
tadbirkorlik	entrepreneurship
tanklar	tanks
soni	number
konfiguratsiyasi	configurations
pastga	down
janrlar	genres
uzum	grape
tomonidan	by
delegatlar	delegates
asbob	tool
sibir	siberian
mutaxassisliklar	specialties
anatomik	anatomical
homilador	pregnant
bokschi	boxer
marganets	manganese
kayfiyat	mood
avtomatlashtirish	automation
zaharlangan	poisoned
vibratorlar	vibrators
mashq	activity
yer	earth
tushunish	understand
telefonlar	phones
klark	clark
krem	after-shave
yomon	atrocious
bombalar	bombs
sharflar	scarves
klub	club
maslahat	advice
harakatlar	actions
kerak	need
guvohlik	testimony
farmakologik	pharmacological
radiologik	radiological
resurslar	resources
qobiliyatli	able
pol	floor
kibr	arrogance
shaxs	person
falokat	disaster
balet	ballet
zaiflashishi	weakening
qadr-qimmati	dignity
kokos	coconut
mavsum	season
kofein	caffeine
uch	three
endotelial	endothelial
detektor	detector
almashish	sharing
telemetriya	telemetry
yengillik	relief
koeffitsienti	coefficient
yuzaki	superficial
monarx	monarch
birdan	abrupt
statsionar	stationary
xaritalash	mapping
javobgar	responsible
qaynatilgan	boiled
egrilik	curvature
blok	block
teleskoplar	telescopes
viktorina	quiz
organ	agency
odatiy	usual
ustunlik	advantage
tuz	salt
tez	instant
kazino	casino
semantika	semantics
tayyorlash	preparation
massa	mass
singil	sister
ayanchli	abject
maysazor	lawn
tarqalgan	distributed
kreditor	creditor
zararsiz	harmless
komikslar	comics
quruvchi	builder
metafizik	metaphysics
limfotsitlar	lymphocytes
yurish	walk
aktin	actin
burchak	angle
tarixchi	historian
qavat	floor
kompressor	compressor
samimiylik	sincerity
hujjat	document
buyurtma	order
aeroplan	aircraft
plitalari	plates
ajinlar	wrinkles
jigar	liver
mutlaq	absolute
xun	diet
hayvon	animal
dinamik	dynamic
kodlari	codes
qoralash	accusation
tinglovchi	listener
niyatidadir	intends
geologik	geological
parda	act
vertolyotlar	helicopters
kommunizm	communism
javoblar	answers
ruhoniylar	priests
kutubxonachilar	librarians
yaroqli	available
aqldan	crazy
homiysi	sponsor
tikan	thorn
neyroxirurgiya	neurosurgery
taqish	tie
yomon	bad
tasodifan	accidentally
tizimi	system
kristallar	crystals
kotiblar	secretaries
kislotali	acidic
javdar	rye
tushdi	fell
jami	amount
sirk	circus
qaramay	despite
mimik	mimic
apoptoz	apoptosis
piramidalar	pyramids
yana	also
matal	adage
tadqiqotchi	researcher
roman	novel
surinam	suriname
prognozlash	forecasting
kislotalar	acids
urinishlar	attempts
valentinlar	valentines
mutlaqo	quite
qiyosiy	comparative
qurolsiz	unarmed
ekish	planting
shifo	healing
kufr	disbelief
balzam	balm
bardoshlik	tolerance
chiqmoq	climb
sehrli	magic
tekisliklar	plains
aniqlik	accuracy
standartlashtirilgan	standardized
lazer	laser
vazirlik	ministry
debet	debit
loyiq	adequate
taqiqlangan	forbidden
zombi	zombie
hayron	wonder
yomon	awful
poezdlar	trains
taqdimot	presentation
likvidligi	liquidity
qarzdor	debtor
interaktiv	interactive
yumshoqroq	softer
qirrali	angular
kolonizatsiya	colonization
oxirgi	last
qidiruvlar	searches
qalamlar	pens
umrboqiy	ageless
bodring	cucumber
abadiyat	eternity
soqov	dumb
yashil	green
terapevt	therapist
tinglovchilar	listeners
reja	plan
munosabat	attitude
haqiqatda	actually
kechqurun	evening
platina	platinum
poyezdda	aboard
aylantirildi	converted
omillar	factors
sekin	slow
yaqinlik	attachment
sitokinlar	cytokines
katalancha	catalan
kulgu	laugh
kommunistlar	communists
xususiyatli	featured
modemlar	modems
piyodalar	pedestrians
normallashtirish	normalization
inkubatsiya	incubation
amfiteatr	amphitheatre
seysmik	seismic
jarrohlar	surgeons
aspirantura	postgraduate
olimlar	scientists
arktika	arctic
evakuatsiya	evacuation
akustik	acoustic
induktiv	inductive
pasayish	decline
diskoteka	disco
fermentatsiya	fermentation
manzara	landscape
tashkilot	association
adolatlilik	fairness
kuchaytiruvchi	enhancer
suvsizlanish	dehydration
tushunilgan	understood
epilepsiya	epilepsy
harorat	temperature
ichidan	through
xamir	dough
teshik	hole
yarim	half
kuz	fall
barabanlar	drums
talaffuz	pronunciation
jodugarlar	witches
fon	background
oz	little
nonushta	breakfast
venetsiyalik	venetian
geroin	heroin
fohishalik	prostitution
klinika	clinic
mustahkam	robust
ulushlar	shares
folga	foil
barcha	all
keldi	came
javobgar	accountant
jihod	jihad
pomidor	tomato
qamchilash	whipping
pastoral	idyllic
kesma	cut
ajratish	separation
originallik	originality
tortishish	shooting
havzalar	basins
tonna	tons
metro	subway
stadion	stadium
kuchli	acute
kvant	quantum
sanoat	industry
tor	narrow
advokatlar	lawyers
belgilash	award
arxiepiskop	archbishop
qatlamlar	layers
rentgenografiya	radiography
direktorlar	directors
qulashi	collapse
evro	euro
ajratmoq	assign
ketma-ketlik	sequence
holat	condition
tabiatshunos	naturalist
yaqindan	closely
plantatsiyalar	plantations
nizolar	conflicts
zilzila	earthquake
tashuvchilar	carriers
vektor	vector
imo-ishora	allusion
oshkoralik	transparency
dushman	adversary
robotlar	robots
boshlanadi	starts
chekkaga	aside
tergovchi	investigator
parazitlar	parasites
sirka	vinegar
kometalar	comets
hojatxonalar	toilets
izolyatsiya	isolation
monogramma	monogram
adashib	astray
sudyalar	judges
xususiy	private
kassir	cashier
diktatorlik	dictatorship
almashtiriladigan	convertible
kamin	fireplace
ochilish	opening
rassom	artist
eshitiladigan	audible
tuproqli	grounded
zindon	dungeon
asboblar	tools
oltmish	sixty
sindromi	syndrome
alamli	painful
buqalar	bulls
sitrus	citrus
ozarbayjon	azerbaijan
yordamchilari	assistants
kordoba	cordoba
ehson	alms
afsus	alas
idora	office
axlat	rubbish
taranglik	tension
motam	mourning
kataloglari	catalogs
burgutlar	eagles
bajarilmadi	failed
beshinchi	fifth
modda	substance
hissiyotlar	emotions
sinf	class
rasadxona	observatory
ikkita	two
tropik	tropical
vaqt	time
poytaxtlari	capitals
kashtan	chestnut
noshud	awkward
boshlari	heads
sessiyalari	sessions
firibgarlik	fraud
parvoz	flight
avvalgi	antecedent
foiz	cent
penitsillin	penicillin
masturbatsiya	masturbation
nishonlar	badges
muborak	blessed
yashayotgan	alive
taqiqlar	prohibitions
falsafalar	philosophies
qoniqarli	satisfactory
gibridlar	hybrids
musobaqalar	competitions
davlatlar	states
arxitektura	architecture
kollektorlar	collectors
prefiks	prefix
takliflar	suggestions
kuchaygan	intensified
gigiena	hygiene
qilma	don't
namlik	moisture
yorqin	bright
mavhum	abstract
arvoh	apparition
sabr	patience
jami	total
bayroqlar	flags
simob	mercury
aylana	around
alkimyo	alchemy
voy	alas
akvalang	aqualung
vaza	vase
tushunchalar	concepts
trek	track
kaltsiy	calcium
oluvchi	addressee
arteriya	artery
nisbatan	than
aristokrat	aristocrat
soat	hour
bajarildi	done
xayrixoh	accessory
kecha	night
miting	rally
voqealar	events
abadiydir	forever
tashqi	appearance
havaskor	amateur
assambleya	assembly
yopishqoq	sticky
mutlaq	absolute
quruq	dry
atributlari	attributes
arxivlar	archives
mehmonxonalar	hotels
jumboq	puzzle
yuvinish	ablution
liberallar	liberals
bibliografiya	bibliography
astronomik	astronomical
intiluvchan	advanced
chiqarmoq	print
transformatorlar	transformers
qofiya	rhyme
kompaniya	company
tezlatkich	accelerator
agenti	agent
patologiya	pathology
respublikalar	republics
xususiyati	feature
ehtirom	awe
linzalari	lenses
haqida	about
sanksiya	sanction
raqib	adversary
romanlar	novels
haqiqiyligi	authenticity
restoranlar	restaurants
orasida	among
yonma-yon	abreast
platsenta	placenta
uchrashmoq	meet
ishoratlar	links
chempioni	champion
marksist	marxist
antibiotik	antibiotic
almashtirish	exchange
uysiz	homeless
plagiat	plagiarism
madhiya	anthem
sedimentatsiya	sedimentation
nutqlari	speeches
mulk	property
konvektsiya	convection
miqdor	amount
namuna	pattern
muxtor	autonomous
sezuvchanlik	sensitivity
konferensiya	conference
gimn	anthem
platformalar	platforms
favvoralar	fountains
impedans	impedance
qizamiq	measles
kumush	silver
kamchiliklar	shortcomings
skalar	scalar
yomonroq	worse
vositachilar	intermediaries
bedana	quail
qayiq	boat
qism	piece
izzat-hurmat	awe
ustida	above
ifodalar	expressions
eynshteyn	einstein
kengash	board
taqsimlash	division
sudlanuvchi	defendant
soliq	tax
sport	sports
inspektorlar	inspectors
karantin	quarantine
kattalar	adults
solih	righteous
patogen	pathogen
masjidlar	mosques
yondashuv	approach
bilgan	knew
qurilgan	built
mafkuraviy	ideological
oltin	gold
igna	needle
qaytadan	again
akvarium	aquarium
tugunlar	nodes
moliya	finance
samarali	effective
adabiy	literary
zarb	tattoo
antologiya	anthology
yosh	age
tarmoq	network
demokratiya	democracy
konverter	converter
ozchiliklar	minorities
motorli	motorized
iyul	july
agar	if
akademiyalar	academies
allergik	allergic
osmon	sky
harakat	action
mixlar	nails
keyinchalik	later
mikro	micro
hushyorlik	vigilance
bufer	buffer
taqvim	calendar
ayblash	accusation
yoz	summer
kimyogarlar	chemists
zanglagan	rusty
dehqonchilik	agriculture
dastur	application
mohir	able
irqiy	racial
ostida	under
nevrologiya	neurology
belgisi	icon
uglevodorodlar	hydrocarbons
alohida-alohida	separately
regenti	regent
javob	answer
yaqin	near
kapitan	captain
nanotexnologiya	nanotechnology
etnik	ethnic
sertifikat	certificate
noyabr	november
tepaliklar	hills
prezidentlik	presidency
demokratik	democratic
nafaqa	alimony
spektrometr	spectrometer
paralimpiya	paralympic
saroy	palace
yaguar	jaguar
tanqidchilar	critics
kutilmagan	unexpected
qora	black
tabu	taboo
uchun	to
neylon	nylon
jonzot	creature
biofizika	biophysics
geometriya	geometry
nazariyotchilar	theorists
ehtirosli	ardent
nikoh	marriage
jele	jelly
ichimlik	drink
ofitser	officer
formulalar	formulas
natija	result
brauzerlar	browsers
qonuniylik	legitimacy
lazzatlanish	enjoyment
qiynoq	agony
statik	static
oqsil	protein
irq	race
marksistik	marxist
portlar	ports
qayerda	where
teskari	reverse
qafas	cage
mahkumlik	conviction
xavotir	anxiety
limfa	lymph
filtrlar	filters
simfonik	symphonic
fotonlar	photons
aranjirovka	arrangement
tanasi	body
optometriya	optometry
jumlalar	sentences
neopren	neoprene
bojxona	customs
vetnam	vietnamese
soch	hair
inch	inch
titroq	trembling
podalar	herds
tahrirlangan	edited
sperma	sperm
ligandlar	ligands
koreys	korean
kulgili	funny
sotib	buy
rok	rock
qochqinlar	refugees
operatsiyalar	operations
grafit	graphite
attashe	attache
quyonlar	rabbits
ilmiy	scientific
tabriklar	congratulations
teta	theta
rahmat	thank
glutamat	glutamate
bitiruvchilari	graduates
yozgan	wrote
oldindan	ahead
olim	scientist
jozibali	attractive
arginin	arginine
kashfiyot	discovery
manbalari	sources
raqqoslar	dancers
mahkama	agency
tizzalari	knees
emigratsiya	emigration
shartsiz	unconditional
kaltaklash	beating
kaktus	cactus
uzaygan	prolonged
tahdid	threat
ichimliklar	drinks
ajratuvchi	separator
oshirmoq	accelerate
faoliyati	activity
tortish	attraction
shlyapa	hat
chora	arrangement
smartfonlar	smartphones
atrof-muhit	environment
urologiya	urology
knyazlar	princes
peshin	afternoon
gilam	carpet
yaqinlar	ambience
leksikon	lexicon
langar	anchor
shanba	saturday
faylasuf	philosopher
nazoratsiz	uncontrolled
kemalar	ships
turar-joy	abode
ekstremistik	extremist
haykal	sculpture
intervyular	interviews
marosimlar	ceremonies
punktuatsiya	punctuation
hokimiyat	authority
martaba	career
parollar	passwords
atrofida	about
sotadi	sells
qirollik	royal
instituti	institute
tayinlangan	appointed
innovatsion	innovative
garajlar	garages
samoviy	heavenly
indeks	index
zarba	shock
etaklari	skirts
quritish	drying
xonadon	apartment
magistratlar	magistrates
inauguratsiya	inauguration
mantiqsiz	absurd
sintetik	synthetic
start	start
tartib	array
madhiya	anthem
bezatilgan	decorated
daryolar	rivers
uglevodlar	carbohydrates
yuz	face
fosfat	phosphate
kamaydi	decreased
monopoliya	monopoly
keyin	then
birlashma	alliance
standart	standard
abonent	subscriber
iqtidor	aptitude
prezident	president
takomillashtirish	improvement
maslahat	advice
faoliyat	activity
munozara	argument
haydovchi	driver
bekon	bacon
yuz	air
tasdiqlaydigan	affirmative
moslashtirish	arrangement
yozuvchi	author
mutafakkir	thinker
avokado	avocado
sarosima	abashment
sokin	calm
tikish	betting
institutsional	institutional
ayyorlik	cunning
anoreksiya	anorexia
nordon	acid
foyda	asset
darvin	darwin
gapirish	speak
nyukasl	newcastle
sintezator	synthesizer
qutisi	box
kamsitish	discrimination
win	win
yard	yard
taxminlar	expectations
mato	fabric
neytral	neutral
bosh	head
kutubxona	library
shiftlar	ceilings
muxtoriyat	autonomy
qiz	girl
aytib	tell
bosqinchilik	annexation
yoshlik	youth
muharrirlari	editors
dividendlar	dividends
oliy	high
arbitr	arbitrator
bevalar	widows
bit	bit
chaqirdi	called
kamroq	less
gistologiya	histology
soxta	fake
kuchli	strong
oshpaz	cook
filial	branch
xaritalar	maps
uzunlik	length
bipolyar	bipolar
prezervativ	condom
kapitanlari	captains
telekom	telecom
avstriyalik	austrian
kollej	college
qiynoqlar	torture
muzokaralar	negotiations
daraja	degree
saytlar	sites
moda	fashion
ekiladigan	arable
elchixonalar	embassies
stop	stop
losonlar	lotions
drayv	drive
rivojlanadi	develops
markazi	center
chelaklar	buckets
guruh	group
dizaynerlar	designers
generallar	generals
poliuretan	polyurethane
qabul	receive
konservatorlar	conservatives
mavzusi	theme
sabzavot	vegetable
sharsimon	spherical
haykallar	sculptures
metropol	metropolis
paltolar	coats
umrbod	lifelong
qisqartirmoq	abridge
dipol	dipole
gibrid	hybrid
rejalashtirish	planning
shahar	city
mutaxassis	expert
missiya	mission
anatomiya	anatomy
adres	address
baytlar	bytes
modellangan	modeled
brokerlik	brokerage
gidroksidi	alkaline
egallash	annexation
dunyolar	worlds
qurbonlar	victims
tirishqoqlik	diligence
shuhratparastlik	ambition
asal	honey
raqamli	digital
nektar	nectar
chaqiruvchi	caller
reklama	advertisement
ustaxonalari	workshops
litva	lithuanian
reklama	advertising
mamlakatlar	countries
vafodorlik	allegiance
mazali	delicious
mitoxondriya	mitochondria
kreditlar	loans
emitent	issuer
mlrd	billion
tegish	touch
farishtalar	angels
boshpana	asylum
boylik	wealth
noaniqlik	uncertainty
vorislar	successors
xohish	aspiration
bugun	today
urush	war
birliklari	units
shovqinsiz	silent
atrofida	around
ishonchsizlik	insecurity
bronza	bronze
mahkamlash	attachment
kasr	fraction
tarafdor	accessory
aynigan	addle
qum	sand
tashvish	apprehension
keskin	acrid
vitaminlar	vitamins
xatti-harakat	attitude
kutilmaganda	abrupt
teleks	telex
sintaktik	syntactic
sabab	cause
arxiv	archive
murabbiylik	coaching
adolat	justice
gadjetlar	gadgets
memfis	memphis
ulushi	share
sovrin	prize
uning	his
tekshirildi	checked
zakot	alms
buyum	article
belgilash	appointment
iqtisodiyot	economy
raf	shelf
yordam	accommodation
qotil	killer
vaziyat	situation
terilari	skins
tishli	threaded
hali	yet
muvofiq	suitable
gazetalar	newspapers
noaniqlik	abeyance
samalyot	aeroplane
munosabat	attitude
ratsionallik	rationality
mahsulot	produce
mahorat	skill
asinxron	asynchronous
shilimshiq	slime
semizlik	obesity
fashist	fascist
qaram	dependent
yozadi	writes
nafrat	anger
kapillyar	capillary
boqiylik	immortality
motorlar	engines
tinchlik	peace
taxminan	approximately
tepdi	kicked
belgilangan	defined
karibu	caribou
sxema	scheme
boshqarmoq	administer
yosh	younger
hurmatli	respected
amaliyotchi	practitioner
kolumbiya	columbia
uyqusizlik	insomnia
monarxiya	monarchy
bordo	burgundy
hushyor	attentive
pudratchi	contractor
protsessual	procedural
ovoz	voice
yunoncha	greek
uzunligi	length
meteorologik	meteorological
jahannam	hell
gap	sentence
turmoq	stand
distrofiyasi	dystrophy
shukrona	appreciation
shakl	form
befarqlik	apathy
lolalar	tulips
batamom	altogether
qon	blood
filippinlar	philippines
ionlash	ionization
vodorod	hydrogen
shoxli	horned
jamoa	community
dunyoviy	secular
mentalitet	mentality
gemoglobin	hemoglobin
kvarta	quart
kosa	bowl
individuallik	individuality
tarjimalar	translations
sahifalar	pages
chumoli	ant
qurish	build
inson	human
moslash	adaptation
tasniflangan	classified
homiylar	sponsors
bezak	ornament
shlyuzlar	gateways
algebraik	algebraic
kiritish	enter
monastiri	monastery
manfaatdor	interested
kamsitilish	abasement
biriktirilgan	attached
izotoplar	isotopes
talab	claim
sulolasi	dynasty
har	each
nuqtasi	point
hujum	attack
tangalar	coins
hunarmandlar	craftsmen
bilaman	know
kontsert	concert
noqulay	awkward
boshlanuvchilar	beginners
dominikan	dominican
polipropilen	polypropylene
jamiyat	society
abdulloh	abdullah
geometrik	geometric
ota-	parent
ajablanib	surprise
medallar	medals
muhit	ambience
trampolin	trampoline
eskizlar	sketches
run	run
quritilgan	dried
tashqarida	out
sentyabr	september
meditatsiya	meditation
banklar	banks
abonentlari	subscribers
suyak	bone
baland	altitude
tanqidlar	criticisms
nomukammal	defective
qurbon	victim
tafsilotlar	details
qadimgi	ancient
barqaror	stable
niderlandiya	netherlands
universitetlar	universities
versiyasi	version
yakshanba	sunday
shablonni	template
kardiologiya	cardiology
qisqartirish	shortening
ajrashgan	divorced
eshitmoq	hear
inqilob	revolution
jurnalistika	journalism
ramkalar	frames
flanel	flannel
ekstatik	ecstatic
deterministik	deterministic
muz	ice
buyruq	command
viski	whiskey
koordinatalari	coordinates
doira	area
atrof	ambience
patriarxal	patriarchal
valyuta	currency
ispan	spanish
sindikat	syndicate
skuterlar	scooters
din	religion
erlar	husbands
xristian	christian
treninglar	trainings
ishontirish	persuasion
up	up
jihoz	accessory
ijobiy	positive
hokimiyat	authority
bostirish	suppress
toj	crown
fotoalbom	fossil
gematologiya	hematology
original	original
tilaklar	wishes
ekvator	equator
shaxsan	personally
gullash	flowering
okt	oct
metanol	methanol
instinktlar	instincts
yorqinligi	brightness
qulflangan	locked
oktan	octane
massalari	masses
ajoyib	great
ajoyib	admirable
millioner	millionaire
badiiy	artistic
eshittirish	broadcasting
portladi	exploded
arxivlar	archives
qisqa	short
patogenez	pathogenesis
mutatsiyalar	mutations
karbonat	carbonate
shlang	hose
aralashmaydigan	aloof
shior	slogan
bilaguzuklar	bracelets
faqat	just
yigitlar	guys
tarjima	translation
jazo	penalty
dekan	dean
kalibrlash	calibration
axloqsizlik	dirt
pechka	stove
usul	approach
saudiya	saudi
navigatsiya	navigation
toni	tony
miya	brain
biografiya	biography
doira	circle
tasvir	image
shaytonlar	devils
yaramas	abominable
suyuqliklar	fluids
korporativ	corporate
suhbatlar	conversations
tasdiqlangan	approved
xato	amiss
xatolar	errors
reaktivlar	reagents
tenglik	equality
xor	chorus
retsept	recipe
ekosistema	ecosystem
funt	pound
makedoniya	macedonian
shisha	glass
madaniy	cultural
guvohlar	witnesses
istisno	exception
daraxt	tree
shahar	town
trening	training
ot	noun
ishsiz	unemployed
adabiyot	literature
abbatlik	abbey
gipoteza	assumption
jirafa	giraffe
issiqxona	greenhouse
anglikan	anglican
tebranishlar	vibrations
kelishuv	agreement
konsoli	console
limuzin	limousine
sulh	accord
missiyalar	missions
va	and
yoqimsiz	unpleasant
xavfsiz	safe
kuylashadi	sing
kompozit	composite
kontseptual	conceptual
sevgi	love
filtri	filter
hazm	absorption
deyarli	almost
aromaterapiya	aromatherapy
zichligi	density
ixtirolar	inventions
xususiyat	attribute
mumkin	can
mustaqillik	independence
yaqinlik	proximity
raqami	number
shkafi	cabinet
fojiali	tragic
rahbarlar	leaders
isbot	alibi
suyuq	liquid
muvofiq	proper
protsessor	processor
aniq	net
malham	ointment
ligaga	league
vodiylar	valleys
mantiqsiz	arbitrary
siljish	shift
avokado	avocado
testosteron	testosterone
bioxilma-xillik	biodiversity
uchburchak	triangle
intiqom	revenge
orkestr	orchestra
huquqlar	rights
bizning	our
vasvasalar	temptations
salkam	almost
protonlar	protons
loviya	bean
mashinalari	machines
strategiya	strategy
tirishish	attempt
arqonlar	ropes
klanlar	clans
instinkt	instinct
vositachilik	mediation
barmoqlar	fingers
chiqindi	waste
irqchi	racist
amerikalik	american
boshqalar	others
prokurorlar	prosecutors
qorin	abdomen
bepushtlik	infertility
tosh	stone
chili	chile
xol	score
ionli	ionic
mehribon	attentive
boy	affluent
peshin	noon
diabet	diabetes
usullari	methods
harflari	letters
ilonlar	snakes
butun	all
barg	leaf
eruvchanligi	solubility
stul	chair
yarash	armistice
baland	tall
budda	buddha
oddiy	simple
cherkov	church
parametrik	parametric
jangchi	warrior
alpinist	climber
tuzatilgan	corrected
uchun	for
faol	active
sxematik	schematic
entsiklopediya	encyclopedia
tugun	knot
anarxiya	anarchy
muqobil	alternative
missionerlar	missionaries
noqulaylik	inconvenience
hujjatlashtirilgan	documented
yemoq	eat
jirkanch	abhorrent
qiziqarli	fun
jurnal	magazine
partiyasi	party
sevishganlar	lovers
maydon	area
vagonlar	wagons
gazeta	newspaper
shvedcha	swedish
moslashuvchan	flexible
nikotin	nicotine
ittifoqdosh	allied
xatti-harakatlari	behaviors
jadval	table
kotibiyat	secretariat
rupiya	rupee
qachon	when
tarkibi	composition
ferma	farm
stol	table
italiyaliklar	italians
iztirob	agony
jilmayib	smiling
issiqroq	warmer
uy	house
bor	are
kommunist	communist
rivojlantirish	develop
jasur	audacious
yoqimli	pleasant
noqulay	uncomfortable
nima	do
qilingan	made
vaziyat	position
turib	stood
chidamlilik	durability
rahmdil	kind
modellari	models
porlaydi	shines
matbuot	press
zararli	adverse
makrofaglar	macrophages
solmoq	arrange
kolumbiyalik	colombian
dekorativ	decorative
nasoslar	pumps
siklon	cyclone
taklifnomalar	invitations
baqirmoq	shout
juda	very
boshliq	chief
shakllantirish	forming
leytenant	lieutenant
zino	adultery
aspirin	aspirin
kechiktirmoq	adjourn
xom	raw
pansionlar	hostels
ustama	appendage
mikroskopik	microscopic
karvon	caravan
nisbati	ratio
tush	dream
muxbirlar	reporters
epizodlar	episodes
ekstremistlar	extremists
zahiralari	reserves
iqtidorli	able
patentlangan	patented
barvaqt	early
chegaralanmagan	absolute
nayza	spear
anormal	abnormal
maksimal	maximum
buqa	bull
natijada	afterwards
tanlang	select
spot	spot
siluet	silhouette
alkogol	alcohol
shimish	absorption
ataylab	deliberately
prokuror	prosecutor
federalizm	federalism
davo	antidote
chinni	porcelain
termodinamika	thermodynamics
pandemiya	pandemic
morfologik	morphological
qarshilik	antagonism
assimilyatsiya	assimilation
antarktika	antarctic
uzumzor	vineyard
izchil	consistent
ish	job
segmentlar	segments
ham	and
buzoqlar	calves
traktor	tractor
meteorologiya	meteorology
kuboklar	trophies
galereya	gallery
rejissyor	director
qariyb	almost
suruv	flock
hisob	account
diareya	diarrhea
trevoga	alarm
yuksak	astronomical
muhrlangan	sealed
ijara	rent
insonparvar	humane
kelishmovchilik	disagreement
ular	they
ritm	rhythm
qiyinchiliklar	difficulties
kengash	assembly
vakili	represent
kapital	capital
pistirma	ambush
engilroq	lighter
ziravorlar	spices
besh	five
tanlash	choose
meningit	meningitis
yaratilgan	created
buta	shrub
zardobni	whey
zilzilalar	earthquakes
ateist	atheist
saqlash	storage
kafolatlar	guarantees
seshanba	tuesday
shirin	sweet
pensiyalar	pensions
atrofida	about
titroq	awe
texnikasi	technique
naturalizatsiya	naturalization
jangari	militant
sotsializm	socialism
palmalar	palms
qanotli	winged
ezoterik	esoteric
shamlar	candles
ikkinchi	second
eritma	alloy
chang	powder
primat	primate
sifat	adjective
chiqish	exit
ierarxik	hierarchical
saqlab	kept
puxtalik	accuracy
taraf	side
dushmanlik	hostility
yoriq	crack
savollar	questions
bochka	barrel
ajdaho	dragon
maydoni	lot
okean	ocean
sakramoq	jump
takson	taxon
zirh	armor
antiseptik	antiseptic
tashkilotchilari	organizer
quritgich	dryer
olti	six
aeroplan	aeroplane
qirrasi	edge
darslar	lessons
ruhoniylik	priesthood
kodeks	codex
brokerlar	brokers
istiqbol	prospect
hasad	envy
umumiy	general
ziyrak	acute
aktyorlar	actors
eski	antique
dramalar	dramas
uzoqda	away
kun	day
kurashchi	wrestler
xabarnoma	advice
implantatsiya	implantation
yetib	arrive
dioksid	dioxide
shahid	martyr
yordam	assistance
biologik	biological
shoxi	horn
baquvvat	athletic
niyatlar	intentions
talaba	student
mutantlar	mutants
sokin	quiet
loyiha	project
uslubchi	methodist
lakros	lacrosse
sizniki	yours
operatorlari	operators
kichkina	small
lokomotiv	locomotive
jirkanch	abominable
turnir	tournament
peptidlar	peptides
quvnoq	cheerful
xabar	message
sessiya	session
kuz	autumn
taksonomik	taxonomic
davomiyligi	duration
albatta	absolutely
ekstraktlar	extracts
burmalar	folds
neyronlar	neurons
qanotlari	wings
aprel	april
kanallari	channels
man	anchor
salmonellalar	salmonella
sherif	sheriff
ishtiyoq	ardour
kreditorlar	creditors
rollar	roles
kreatin	creatine
konsalting	consulting
ongli	conscious
avlod-ajdod	antecedent
qaramlik	dependency
taassurotlar	impressions
ogoh	alert
rangpar	ashy
davrlari	circuits
nonlar	breads
teleskop	telescope
ekologiya	ecology
toza	aseptic
uzluksizligi	continuity
sharaflangan	honored
baholanmagan	unrated
mototsikllar	motorcycles
aspekt	aspect
filtrlangan	filtered
motellar	motels
urinish	attempt
hajmi	size
qamchi	whip
yelkama-yelka	abreast
reflektor	reflector
borish	go
nasabnomasi	genealogy
hal	solve
bodibilding	bodybuilding
kattalashtirish	enlarge
qurbaqalar	frogs
navlari	varieties
hosildorlik	productivity
lideri	leader
dinamit	dynamite
baxtli	happy
farishta	angel
ortida	behind
jim	silent
harakat	move
ajratmoq	appropriate
embrionlar	embryos
yoqimli	agreeable
bosim	pressure
xizmatlar	services
kunlik	daily
tartibsizlik	anarchy
voqea	event
taklif	suggest
qiymati	cost
imperator	emperor
ilova	appendix
joylashtirmoq	allocate
ingl	visual
tashish	transportation
missionerlik	missionary
volfram	tungsten
qishloq	village
bitiruv	graduation
muvofiqligi	compatibility
aksent	accent
tun	night
qirol	king
akkumulyator	accumulator
befarqlik	indifference
kiyim	dress
bildirmoq	acquaint
xayolparast	dreamer
ramz	symbol
sinishi	fracture
kurdlar	kurds
shaxsiyat	personality
dard	ache
kulgili	amusing
dilerlar	dealers
zirh	armor
politsiya	police
shahzoda	prince
yoqlovchi	accessory
dengizchi	sailor
urushlar	wars
paytda	while
komissiya	commission
batareya	battery
genotsid	genocide
xafta	week
homiylik	sponsorship
kuzatuvchi	observer
katalizator	catalyst
majburlash	coercion
rangli	colorful
oldingi	aboriginal
hovuz	pool
xavf	danger
benzol	benzene
anjir	fig
alyuminiy	aluminium
mish-mishlar	rumors
bor	got
kremlar	creams
sudlar	courts
asfalt	asphalt
fikrlar	ideas
milya	mile
dupleks	duplex
yaxshilik	goodness
qurilmalar	devices
son-sanoqsiz	countless
agentlari	agents
yondi	burned
emasman	am
vinil	vinyl
faraz	hypothesis
forumlar	forums
qisdi	shrugged
halollik	honesty
umidvor	hopeful
latifa	anecdote
asbest	asbestos
majmua	anthology
metabolizm	metabolism
ehtimolli	probable
hikoyalar	stories
yurist	lawyer
muhr	seal
tepa	apex
josuslar	spies
boshlanishi	begin
jurnalist	journalist
astronavtlar	astronauts
farmatsevtlar	pharmacists
qirolicha	queen
holokost	holocaust
ballar	points
kosmonavt	astronaut
omad	luck
ishonch	assurance
fashizm	fascism
hujum	aggression
taksonomiya	taxonomy
masal	parable
qulflash	lock
dozalari	doses
kardio	cardio
xarakter	attitude
konturlar	contours
peshonasi	forehead
nikola	nicola
falaj	paralysis
talab	require
istilo	invasion
emissiya	emission
alpaka	alpaca
tipografiya	typography
sek	sec
ziddiyat	antagonism
yaratuvchisi	creator
yangilash	update
fayl	file
xizmatkor	servant
davlat	state
kompaniyalar	companies
milliy	national
shoh	king
sharafli	honorable
tuzlar	salts
sinov	assay
immunologiya	immunology
ipoteka	mortgage
qistirmalari	gaskets
premyerasi	premiere
shiorlar	slogans
artilleriya	artillery
tesha	adze
tilshunoslik	linguistics
shartnoma	agreement
chaqaloqlar	babies
novda	rod
kongresslar	congresses
lirik	lyrical
zamonaviy	modern
ishsizlik	unemployment
aravachalar	carts
vazifa	task
ov	hunt
tasdiqlaydigan	assertive
futbolchi	player
sxemalar	schemes
samimiy	amiable
vulqon	volcanic
mulohazali	advisable
komplekt	apparatus
yumshoq	soft
katta	big
gepatit	hepatitis
investorlar	investors
dozalash	dosing
ixtiyoriy	arbitrary
afrikaliklar	africans
duradgorlik	carpentry
artileriya	artillery
batamom	absolute
raqamlangan	numbered
erkin	arbitrary
vanna	bath
elchi	ambassador
mukammal	perfect
bitirgan	graduated
parda	curtain
quruqlikda	ashore
bakalavrlar	bachelors
anod	anode
tahqir	abuse
magnitlangan	magnet
shaftoli	peach
lazzat	flavor
bunday	such
kameralar	cameras
yuzalar	surfaces
xazinalar	treasures
bakteriyalar	bacteria
seminarlar	seminars
broshyuralar	brochures
baholamoq	appraise
distillangan	distilled
arzonroq	cheaper
shifoxona	hospital
odekolon	cologne
ekranlar	screens
kiber	cyber
topologiya	topology
mashina	machine
mulkdor	proprietor
quvvat	energy
nitrat	nitrate
ibrohim	ibrahim
polikarbonat	polycarbonate
gilamlar	carpets
bukilmas	adamant
uyqu	sleep
sigareta	cigarette
hududlar	regions
nomlanmagan	unnamed
akrobat	acrobat
aniq	accurate
tushunarsiz	unclear
match	match
chiqmoq	ascend
kemiruvchi	rodent
derbi	derby
butunlay	absolutely
odatlar	habits
akademiya	academy
rouming	roaming
orgazm	orgasm
erishi	melting
himoya	protection
akkreditatsiya	accreditation
erkinlik	freedom
parishonxotir	absent-minded
elektrostatik	electrostatic
muharriri	editor
imtiyozlar	privileges
tariflari	tariffs
xayolot	apparition
minglab	thousands
qudrat	might
makroiqtisodiy	macroeconomic
chempionlar	champions
kechikish	delay
dalil	proof
gen	gene
surunkali	chronic
kokteyllar	cocktails
vegetativ	vegetative
tamomila	all
qabila	tribe
sirt	surface
iqtidor	ability
qidirish	search
sulfat	sulfate
qalqon	shield
navbatda	agenda
deprivatsiya	deprivation
loqayd	aloof
bildirish	advice
afsonaviy	legendary
sarguzasht	adventure
chekuvchilar	smokers
haqorat	abuse
ahmoq	stupid
qassob	butcher
darslik	textbook
antitsiklon	anticyclone
hind	indian
diametri	diameter
ehtimollik	probability
yuzi	face
hisoblagich	counter
marta	times
sodda	artless
jonlantirish	animation
aerobika	aerobics
ahd	covenant
tadbir	arrangement
qismlariga	components
qaror	decision
duradgorlar	carpenters
qobiliyat	aptitude
yangilangan	updated
telekommunikatsiya	telecommunication
kamonboz	archer
qoladi	remains
fashistlarning	nazi
sirli	mysterious
teng	equal
maskarad	masquerade
telefon	telephone
domenlari	domains
askarlar	soldiers
chaqaloq	baby
maxsus	special
kiyim-kechak	apparel
soxta	artificial
namuna	sample
fakultet	faculty
karta	card
u	it
yelim	adhesive
royalti	royalty
oqim	flow
boshboshdoqlik	anarchy
pitch	pitch
karusel	carousel
natriy	sodium
dalil	argument
paydo	appear
aslida	actually
genetikasi	genetics
ulagichlar	connectors
chivin	fly
tarafdorlari	supporters
doimiy	permanent
simfoniya	symphony
gips	plaster
depozit	deposit
barometr	barometer
miniatyuralar	miniatures
polineziya	polynesia
topadi	finds
yod	iodine
margimush	arsenic
adsorbsiyasi	adsorption
nayza	arrow
mikroskop	microscope
aniqlamoq	assess
mezon	criterion
nimaga	why
yaraydigan	available
konsortsium	consortium
tabassum	smile
yuksalish	ascent
passiv	passive
dard	agony
piyoda	pedestrian
morfologiya	morphology
kutilmagan	anomalous
madagaskar	madagascar
ishladi	worked
tushadi	falls
xantal	mustard
plakatlar	posters
vizantiya	byzantine
kun	gun
ekzogen	exogenous
faza	phase
lavlagi	beet
jismoniy	physical
xunuk	abhorrent
yashagan	lived
yuborish	send
sakkizinchisi	eighth
kattalik	magnitude
suveren	sovereign
muxolifat	opposition
faqat	only
audiovizual	audiovisual
nafis	aesthetic
trubka	tube
elchixona	embassy
avtograf	autograph
doim	always
laboratoriya	laboratory
elektromagnit	electromagnetic
leksik	lexical
oladigan	receivable
landshaftlar	landscapes
shina	tire
ehtimolliklar	probabilities
grammatika	grammar
obunalar	subscriptions
samara	action
eskiz	sketch
yuzlari	faces
tormozlanish	braking
debyutlar	debuts
voizlar	preachers
naqshli	knitted
hid	smell
musiqachilar	musicians
jami	aggregate
bulutlar	clouds
ekvatorial	equatorial
qisqartma	abbreviation
kimning	whose
asossiz	arbitrary
yuzlab	hundreds
oylik	monthly
hukumatlar	governments
saksafon	saxophone
aralashgan	mixed
glaukoma	glaucoma
xizmat	service
xabarchi	messenger
kuchaytirish	reinforce
bloggerlar	bloggers
shafqatsizlik	cruelty
signal	alarm
immunitet	immunity
kollejlar	colleges
serbcha	serbian
ehtimol	perhaps
tegmaslik	optimum
demografik	demographic
interpolyatsiya	interpolation
berish	award
iyun	june
britaniya	britain
italyancha	italian
talab	application
vahima	alarm
mushuk	cat
artrit	arthritis
birlashish	merger
energiya	energy
chipta	ticket
birlik	unit
ishqor	acid
sevilgan	loved
samolyot	airplane
yara	wound
buxgalter	accountant
juftlashtirish	pairing
qadoqlash	packaging
avgust	august
elektronika	electronics
aniq	certain
tanga	coin
dalillar	evidence
simsiz	wireless
qashshoqlik	poverty
afzal	rather
depressiya	depression
qadrlash	appreciation
qarzlar	debts
muhrlar	seals
uzoq	long
soatlik	hourly
tomoni	side
xalqlar	peoples
etilen	ethylene
kanonik	canonical
siyoh	ink
poligon	polygon
strategik	strategic
antioksidantlar	antioxidants
qanaqasiga	how
shartli	conditional
muvaffaqiyat	acquisition
mash	mesh
shifokorlar	doctors
kutilmaganda	suddenly
zal	hall
muhandislar	engineers
nimadir	any
shartnomalar	contracts
shinalar	tires
joylashtirish	arrangement
ovchi	hunter
lyuk	hatch
ajratilgan	separated
ushla	hold
soqol	beard
baxtsiz	unhappy
muvozanatsiz	unbalanced
haydaladigan	arable
soxtalik	affectation
yuk	load
uyushmalar	associations
qulaylik	convenience
butunlay	entirely
jurnallar	magazines
taxt	throne
boshqaruvlari	controls
motor	engine
soat	clock
ekipaj	crew
tumor	amulet
minorasi	tower
sakkiz	eight
bosildi	pressed
bitlar	bits
kilometr	kilometer
oliyjanob	noble
xaridorlar	customers
ismsiz	anonymous
muntazamlik	regularity
spektr	spectrum
tashnalik	thirst
sozlash	settings
soniya	seconds
engil	light
oqlovchi	advocate
mudhish	awful
ohaktosh	limestone
komediyalar	comedies
elektroforez	electrophoresis
vahima	panic
yoshida	aged
konferentsiyalar	conferences
yoqimsiz	averse
debyut	debut
tirozin	tyrosine
himoyachi	defender
sammit	summit
bilvosita	indirectly
arbitraj	arbitration
xususda	stuck
qaytarmoq	annul
xavotirli	anxious
entomologiya	entomology
tovon	indemnification
kiritish	add
mos	appropriate
tayvan	taiwan
yanvar	january
tish	tooth
larza	awe
tashvish	ado
jarayonlar	processes
istisnolar	exceptions
ikki	two
qari	old
kriminologiya	criminology
uxlayotgan	asleep
atipik	atypical
analizator	analyzer
kampaniya	campaign
kovboy	cowboy
biriktirish	attachment
karlik	deafness
panoramik	panoramic
tahorat	ablution
yupiter	jupiter
zodagon	aristocrat
murojaat	appeal
raketa	rocket
petitsiya	petition
kinetik	kinetic
iloj	antidote
islohot	reform
integratsiya	integration
sarguzashtlar	adventures
yozuvchi	writer
intuitiv	intuitive
jip	jeep
orqasida	behind
tranzit	transit
metabolik	metabolic
selsiy	celsius
proba	probe
boyqushlar	owls
oxirgi	final
bamper	bumper
sarosimalik	abashment
neytron	neutron
mumi	wax
yomonlik	evil
farq	vary
eksponatlar	exhibits
sezgi	sense
genetik	genetic
veterinar	veterinarian
zanjabil	ginger
formatlash	formatting
xandaq	trench
saroylar	palaces
tumanlar	districts
yaratadi	creates
sirlari	secrets
biznes	business
xususiylashtirish	privatization
demokratlar	democrats
raketalar	rockets
infrastruktura	infrastructure
kodlangan	encoded
giyoh	cocaine
qarshilik	resistance
bahor	spring
afzalliklar	preferences
qiyin	arduous
tahlilchilar	analysts
iqtisodchilar	economists
oqayotgan	flowing
byudjetlar	budgets
erishmoq	arrive
narsa	thing
bayonotlar	statements
radikallar	radicals
muruvvat	favor
alifbo	alphabet
tayyorlik	willingness
komediya	comedy
nusxalari	copies
geliy	helium
tuzoq	trap
tuxumdon	ovary
qurolli	armed
solishtirish	compare
gumbaz	dome
muxlislar	fans
bargli	leafy
reproduksiyalar	reproductions
kamon	arc
tibbiy	medical
posilkalar	parcels
vakolat	authority
simmetriya	symmetry
ulovlar	mounts
tasodif	chance
paneli	panel
niyat	aim
yarmarkalar	fairs
uchinchisi	third
teskari	anomalous
uzoq	far
rejasi	plan
barglari	leaves
alohida	apart
yoshi	age
ombor	warehouse
parlament	parliament
moliyalashtirish	financing
taxminan	about
korpus	corpus
jun	wool
dunyoqarash	worldview
kashfiyot	invention
epik	epic
marra	finish
qaysi	which
haqida	about
hozirgi	current
lotereya	lottery
shtatlar	states
oktyabr	october
moviy	blue
qarz	debt
ochiq	open
transmilliy	transnational
hashamatli	luxurious
albom	album
atirgullar	roses
foyda	stead
yonma-yon	adjacent
najot	salvation
faollari	activists
ehtiyojlari	needs
qoplamalar	coatings
mis	copper
qarorlar	decisions
tekshiruvchi	inspector
tashuvchisi	carrier
qusish	vomiting
xatolik	error
chegaralari	boundaries
tasavvur	imagination
guldasta	bouquet
saxiylik	generosity
arteriyalar	arteries
tepki	accelerator
norasmiy	informal
ikkinchidan	secondly
hisoblash	computational
uchuvchi	pilot
isbotlash	prove
poyabzal	shoes
sodir	occur
millat	nation
vazirlar	ministers
korroziya	corrosion
quvonch	joy
tekshiruvlar	inspections
xonim	lady
jang	fight
nosimmetrik	symmetric
skleroz	sclerosis
kulgu	laughter
yaxlitlash	rounding
termometrlari	thermometers
janub	south
unumdor	fertile
infraqizil	infrared
kubok	cup
ming	thousand
noodatiy	unusual
vasiylar	guardians
hukmdori	ruler
nabirasi	grandson
darajasi	rate
yiring	abscess
enzim	enzyme
senat	senate
chastotalar	frequencies
tasvirlab	describe
qiziqarli	interesting
monografiyalar	monographs
biologiya	biology
qarz	arrears
inqiloblar	revolutions
qoplama	cover
jamoalar	communities
aniq	exact
surprise	surprise
ham	also
kreyserlar	cruisers
bir	one
fotografiya	photography
arbob	agent
yashash	living
xotira	memory
ritorika	rhetoric
etnografik	ethnographic
hayvonlar	animals
tuzmoq	arrange
kamar	arc
aktrisalar	actresses
baxtsizlik	affliction
zaryadlash	charging
hazillar	jokes
xizmat	serve
kommunikativ	communicative
dengizchilik	maritime
xarobalar	ruins
sekretsiya	secretion
kuchliroq	stronger
anabolik	anabolic
auksion	auction
maqbul	admissible
qobiliyati	ability
chaqirish	call
koalitsiya	coalition
faxriylar	veterans
avstraliyaliklar	australians
bob	article
dollar	dollars
emulyatsiya	emulation
baholovchi	appraiser
ranglar	colors
mashhur	famous
hozirgi	present
yuguruvchilar	runners
birdamlik	solidarity
kechirmoq	absolve
muqarrar	inevitable
kafolatlangan	guaranteed
ustunlik	superiority
ogohlantirilgan	warned
raqam	numeral
hamshira	nurse
kanadalik	canadian
kech	late
shovqin	noise
hujayra	cell
maqsad	aim
maktab	school
kelmoq	arrive
suzmoq	sail
mantiq	logic
bayonot	statement
mebel	furniture
avtomatik	automatic
karlos	carlos
tomoshabin	audience
muvaffaqiyat	success
skeptitsizm	skepticism
iltifot	compliment
tunis	tunisia
skafandr	armor
biluvchi	aware
zarralar	particles
massaj	massage
joylar	places
nuqtalar	dots
bariton	baritone
shirin	pretty
sozlash	amendment
birodarlar	brothers
avf	amnesty
tulki	fox
psixiatriya	psychiatry
ortdi	increased
faktlar	facts
rahm-shafqat	compassion
veronika	veronica
mol-mulk	asset
metan	methane
shaxsiy	personal
mollari	goods
uzatish	transmission
tanitish	introduce
arra	saw
mavzu	subject
progressiv	progressive
qamrovi	coverage
algoritm	algorithm
manfaatlar	benefits
elektron	electronic
pasaytirmoq	abate
chamadon	suitcase
sohilda	ashore
tayfun	typhoon
hamkor	associate
belgi	attribute
konsignatsiya	consignment
arablar	arabs
jinnilik	madness
rohiblar	monks
qoniqish	satisfaction
abiturientlar	entrants
haydash	ride
qilgan	did
provayderi	provider
mos	fit
soyabon	umbrella
efedrin	ephedrine
uchrashuvlar	meetings
qaychi	scissors
markaz	center
karotid	carotid
kostyumlari	suits
buyrak	kidney
korporatsiyalar	corporations
teoremalar	theorems
yollangan	hired
kabel	cable
tezlashdi	accelerated
astronom	astronomer
energetik	energetic
kamalak	rainbow
yaxshilandi	improved
shish	tumor
operalar	operas
bazalar	bases
brendi	brandy
ijrochilar	performers
uchqunlar	sparks
oqsoqollar	elders
prognoz	prognosis
ekzotik	exotic
qanday	how
membrana	membrane
doimo	constantly
tez	quick
bular	these
chunki	because
ifloslangan	polluted
abraziv	abrasive
noorganik	inorganic
topish	locate
beparvolik	negligence
jonlanish	revival
pedagogik	pedagogical
berishi	give
sutemizuvchilar	mammals
vahshiylik	atrocity
yaxshilab	thoroughly
gruziya	georgia
ikkilanish	hesitation
tinglash	listening
yaqin	close
mutlaqo	absolutely
magniy	magnesium
tsement	cement
qoziq	pile
spekulyativ	speculative
montaj	assembly
kitob	book
berdi	gave
ishlash	performance
munosib	appropriate
mifologiya	mythology
inventar	inventory
propan	propane
aorta	aorta
uzoqqa	away
hukmdorlar	rulers
surtma	grease
suzuvchi	floating
teshilgan	perforated
zanjirli	chained
porno	porn
nigeriyalik	nigerian
dama	checkers
sifatida	as
avgust	august
tadbirkorlar	businessmen
giyohlar	herbs
amirliklar	emirates
tanlangan	selected
sehrgar	sorcerer
uzatilgan	transmitted
oilalar	families
ziyrak	astute
boshpanalar	shelters
tozalagichlar	cleaners
qoplangan	covered
chiziqlar	strips
his	felt
polkovnik	colonel
tashlangan	thrown
armada	armada
munozaralar	discussions
kuzatish	observe
atrofda	around
etak	apron
lyuteran	lutheran
xohish	ambition
hinduizm	hinduism
yangidan	anew
ibroniycha	hebrew
majburiy	mandatory
kurs	course
rozilik	consent
zolim	atrocious
kimdir	any
kerak	must
smartfon	smartphone
qor	snow
tekis	plain
kutubxonalar	libraries
konvensiya	convention
barbar	barbarian
jamoaviy	collective
baliqchilar	fishermen
burchakli	angular
munajjimlik	astrology
kimyogar	chemist
albatros	albatross
sinovlari	tests
tuzatish	amendment
ventilyatsiya	ventilation
xarob	ruin
turish	stand
tadqiqotchilar	researchers
nisbiy	relative
biokimyoviy	biochemical
savat	basket
tasdiqlash	confirmation
hammasi	aggregate
tramvay	tram
tezligi	speed
gomoseksual	homosexual
hamroh	accomplice
insholari	essays
fermentlar	enzymes
kvadratchalar	squares
vakolatxona	agency
dermatit	dermatitis
tuzilishi	structure
peshtoq	arch
yordam	help
repetitorlik	tutoring
yalpi	gross
vulkan	volcano
imtiyozli	privileged
aktyor	actor
maqsadlar	goals
nabiralari	grandchildren
modda	article
erishadi	achieves
amper	amp
paketlar	packages
impuls	impulse
klonlar	clones
zararli	harmful
ular	those
yapon	japanese
minerallar	minerals
kriket	cricket
vakansiya	vacancy
filmografiya	filmography
yer	ground
langarlar	anchors
zanjir	chain
kerosin	kerosene
sening	your
qandaydir	anything
sodiqlik	allegiance
fuqarolik	citizenship
ellik	fifty
sintaksisi	syntax
moslashtirish	adaptation
birov	anyone
muvozanatli	balanced
byurokratik	bureaucratic
sektor	sector
lift	lift
foydalanish	use
hidlar	odors
faoliyat	action
gidrologiya	hydrology
soqchilar	guards
biroq	however
butalar	bushes
huquqshunoslik	jurisprudence
tugaydi	ends
muzlatish	freezing
bosilgan	printed
qoidalar	rules
marafon	marathon
paypaslagich	antenna
sichqonlar	mice
xabardor	aware
tashqarida	outside
asr	century
klounlar	clowns
mahsulot	product
kim	who
psixolog	psychologist
sporadik	sporadic
mukofotlar	rewards
rejalari	plans
narxlari	price
mashina	car
parcha	piece
tushunmoq	consider
tailandcha	thai
titanlar	titans
haqiqat	truth
nazorat	control
papkalar	folders
liboslar	dresses
maqol	adage
polimer	polymer
tanaffuslar	breaks
yigirmanchi	twentieth
didli	aesthetic
magnitlar	magnets
axloqsiz	immoral
morfin	morphine
eksa	axis
stabilizator	stabilizer
yelkanlar	sails
sotish	sell
ruxsatnomalar	permissions
ikkiyuzlamachilik	hypocrisy
sinfdoshlar	classmates
burchak	corner
klaviaturalari	keyboards
allaqachon	already
ofatlar	disasters
qiyofa	appearance
pistonlar	pistons
askar	soldier
kuzatuvchilar	observers
isitish	heating
kortikal	cortical
aytdi	told
pekin	beijing
sterilizatsiya	sterilization
asr	age
erkak	male
disklar	disks
minnatdorchilik	appreciation
yurisdiktsiya	jurisdiction
yordam	asset
polipeptid	polypeptide
kiyingan	dressed
greyderlar	graders
konfederatsiya	confederation
mahorat	art
tanho	secluded
urmoq	beat
iymon	believe
hojilar	pilgrims
malak	angel
turlari	types
ammiak	ammonia
mustaqil	independent
tomchi	drop
voiz	preacher
sogʻish	milking
soʻz	word
koʻrgazmalar	exhibitions
gʻayratli	active
gʻayritabiiy	anomalous
toʻldirish	fill
oʻrgimchaklar	spiders
qoʻrqitish	intimidation
qoʻshimchasi	suffix
qovurgʻa	rib
oʻlchov	measure
toʻylar	weddings
bogʻbon	gardener
koʻrshapalak	bat
oʻtkir	sharp
oʻsimlik	plant
oʻpish	kiss
nafaqaxoʻrlar	pensioners
qoʻshiqlari	songs
toʻplami	package
oʻzim	myself
oʻnlab	dozens
qoʻrqqan	afraid
koʻr	blind
qozogʻiston	kazakhstan
moʻljal	aim
oʻzgarmaydigan	variable
palagʻda	addle
qoʻllar	hands
yolgʻizlik	loneliness
toʻqimachilik	textile
koʻngillilar	volunteers
togʻli	mountainous
eʻlon	announcement
oʻxshash	alike
toʻplam	collection
toʻy	wedding
oʻxshashliklar	similarities
oʻsmir	adolescent
shohkoʻcha	avenue
toʻquvchi	weaver
oʻqituvchilar	teachers
koʻrinmas	invisible
choʻtkalar	brushes
gʻoliblar	winners
toʻkilgan	spilled
qoʻshmoq	append
oʻttiz	thirty
gʻayri-tabiiy	abnormal
qoʻltiq	armpit
koʻllar	lakes
koʻp	many
oʻlchovli	dimensional
uygʻoq	awake
boʻlinma	quotient
gʻavgʻo	ado
oʻrgatish	teach
toʻlash	pay
aʻzolik	membership
urugʻlantirish	fertilization
qoʻllanmasi	manual
choʻt	abacus
ogʻriq	anguish
qoʻshin	army
toʻplash	assembly
toʻqimalar	tissues
maʻlumotnoma	reference
taʻmirlash	repair
ogʻzaki	verbally
oʻxshamoq	approximate
koʻrinish	view
anʻana	tradition
sogʻlom	able-bodied
yigʻindi	amount
boʻylab	across
shugʻullanmoq	attend
yogʻlar	oils
qoʻshing	add
oʻchoq	oven
oʻrmonlar	forests
taʻsir	action
moʻl	abundant
yoʻlovchilar	passengers
qoʻzilar	lambs
boʻronli	stormy
gʻalati	alien
oʻsadi	grow
yoʻlak	aisle
maʻlum	known
maʻqul	admissible
yoʻq	no
ogʻriq	pain
ogʻriqlari	pains
koʻpriklar	bridges
toʻyinganlik	saturation
ogʻish	deviation
soʻzlovchi	announcer
boʻsh	empty
moʻl-koʻl	affluent
yoʻl	road
dagʻal	abrasive
oʻrim-yigʻim	harvesting
yigʻish	assembly
toʻxta	stop
yoʻl	path
choʻponlar	shepherds
doʻkon	store
oʻxshatma	analogy
oʻrdak	duck
qoʻshiq	song
yoʻqotishlar	losses
qoʻrquv	awe
soʻrov	request
koʻkatlar	greens
oʻrtacha	average
qoʻlyozmalar	manuscripts
boʻgʻinlar	joints
oʻzgarishlar	changes
koʻpaytirish	reproduction
qoʻmondonlar	commanders
koʻtarilmoq	ascend
toʻsatdan	accidentally
choʻloq	lame
oʻrik	apricot
togʻ	mountain
oʻrnatish	installation
qorongʻu	dark
gʻildiraklar	wheels
qoʻshmoq	associate
doʻstlik	friendship
boʻyicha	on
boʻyinturuq	yoke
boʻri	wolf
toʻgri	accurate
toʻgarak	circle
togʻlar	mountains
yigʻlab	weeping
qoʻrqqan	afraid
maʻmuriy	administrative
qoʻziqorinlar	mushrooms
tugʻma	born
yogʻli	greasy
qoʻshimcha	addition
boʻlish	be
qoʻshiqchilar	singers
koʻtarilish	ascent
feʻl	verb
oʻyin-kulgi	entertainment
koʻrsatadi	indicate
toʻpiq	ankle
qoʻshnilar	neighbors
oʻynamoq	play
jamgʻarmalar	savings
qizgʻin	intense
oʻnlik	decimal
qaygʻurish	attention
laʻnatlangan	cursed
gʻayratli	enthusiastic
koʻproq	more
oʻzingizni	yourself
qoʻllab-quvvatlovchi	supportive
oʻninchi	tenth
yolgʻiz	alone
ishgʻol	occupation
dubulgʻa	helmet
toʻqilgan	woven
xoʻjayin	boss
oʻrtasida	between
koʻrsatma	guide
taʻkidlangan	highlighted
oʻtishi	pass
koʻpmillatli	multinational
choʻqqi	apex
choʻchqa	pig
goʻl	artless
baʻzan	sometimes
qoʻllanma	guide
eʻlon	announcement
makkajoʻxori	corn
oʻrik	apricot
qoʻshish	addition
koʻrsatish	show
merosxoʻr	heir
oʻxshovsiz	awkward
tugʻilish	birth
toʻqnashuv	collision
moʻljallangan	designed
oʻsishi	growth
maʻnosi	meaning
qoʻngʻiz	beetle
choʻkindilar	sediments
eʻlon	advertisement
boʻyin	neck
burgʻulash	drilling
ragʻbatlantirish	incentive
choʻllar	deserts
yigʻilish	meeting
yoʻtal	cough
boʻlimlari	sections
changʻichilar	skiers
gʻalaba	victory
koʻzoynaklar	glasses
soʻzlar	words
qoʻshilaman	agree
oʻlchovlar	measurements
sheʻr	poem
vaʻda	promise
toʻgʻon	dam
ochkoʻz	avid
toʻp	ball
doʻstlar	friends
oʻchirish	delete
ogʻriq	ache
oʻlchamlari	dimensions
ochkoʻz	greedy
bugʻ	steam
qoʻmita	committee
oʻtli	grassy
oʻlik	dead
qoʻl	arm
oraligʻi	interval
koʻchirish	carry
oʻrgatgan	taught
koʻrinish	act
koʻrsatuv	array
oʻq-dori	arms
yomgʻirli	rainy
koʻndalang	across
roʻyxat	list
toʻla	complete
choʻchqalar	pigs
oʻlgan	dead
doʻl	hail
bogʻliqliklar	dependencies
qoʻshimcha	appendage
yoʻqoladi	disappears
oʻrtasida	amid
taʻsiri	effect
oʻqituvchi	teacher
oʻgʻil	son
qoʻlga	caught
joʻja	chick
toʻplam	set
koʻtariladi	rises
oʻgʻrilar	thieves
maʻbuda	goddess
oʻrtasida	among
toʻplash	collect
koʻylak	shirt
koʻcha	street
choʻntak	pocket
toʻrt	four
qirgʻoqda	ashore
ogʻir	arduous
toʻsiqlar	obstacles
yolgʻiz	lone
toʻlqin	wave
soʻrovlar	queries
toʻqqiz	nine
ogʻir	heavy
qoʻngʻiroqlar	calls
feʻl	character
gʻarb	west
koʻmak	assistance
qoʻrquv	apprehension
qoʻpol	abrasive
oʻq	axis
toʻlovlar	payments
toʻkish	shed
qoʻshma	joint
gʻalati	anomalous
gʻishtlar	bricks
boʻshliqlar	spaces
tugʻma	congenital
changʻichi	skier
oʻxshash	similar
qirgʻoqlari	shores
yonilgʻi	fuel
qoʻshimchalar	additions
oʻsdi	grew
taʻsir	effect
koʻpaytirib	multiply
eʻtibor	attention
qoʻmitasi	committee
oʻpdi	kissed
yoʻlovchi	passenger
yorugʻlik	light
zoʻravonlik	violence
oʻrinbosar	assistant
oʻxshaydigan	approximate
oʻrgimchak	spider
boʻyoqlar	paints
soʻkish	abuse
choʻchigan	afraid
toʻsiq	barrier
bogʻliqlik	attachment
boʻgʻin	syllable
aʻzolari	members
ogʻriqsiz	painless
bogʻlar	gardens
qoʻlqoplar	gloves
koʻz	eye
oʻqlar	arrows
yoʻqotadi	loses
sogʻlom	healthy
daʻvo	allegation
koʻk	blue
toʻqqizinchi	ninth
sanʻat	art
urugʻ	seed
gʻalati	strange
toʻrtta	four
ragʻbatlantiradi	stimulates
oʻtkir	acrid
joʻshqinlik	enthusiasm
boʻylab	along
sariyogʻ	butter
oʻzlashtirildi	mastered
shagʻal	gravel
zoʻrlangan	raped
qaragʻay	pine
poraxoʻrlik	bribery
ogʻayni	acquaintance
toʻlangan	paid
oʻqish	read
oʻsish	increase
urgʻu	accent
koʻylagi	jacket
ogʻir	austere
oʻzlashtiruvchi	advanced
oʻxshashlik	affinity
oʻrmon	forest
toʻgʻri	correct
toʻlovchilar	payers
koʻrilgan	seen
soʻl	macro
lugʻatlar	dictionaries
toʻrtburchaklar	rectangular
toʻda	crowd
qoʻyish	put
nomaʻlum	unknown
oʻyin	game
oʻrgatadi	teaches
oʻgʻirlash	kidnapping
bogʻlamoq	affiliate
obroʻli	authoritative
oʻchoqlari	ovens
qoʻylar	sheep
oʻgʻitlar	fertilizers
koʻpincha	often
oʻtirib	sit
oʻzgarmaydigan	ageless
toʻla-toʻkis	absolutely
oʻldirish	kill
boʻlinish	division
maʻqul	acceptable
xoʻjasizlik	anarchy
oʻgʻirlik	theft
yorugʻ	bright
koʻchmanchi	nomadic
soʻyish	slaughter
qoʻmondon	commander
boʻlishli	affirmative
oʻrganish	study
oʻnglash	amendment
toʻgʻrisida	about
oʻtkazuvchanlik	permeability
yoʻnaltirilgan	oriented
bogʻ	garden
joʻjalar	chicks
notoʻgʻri	wrong
qoʻshinlar	troops
sugʻurta	insurance
gʻiybat	gossip
oʻrtacha	average
taʻminlash	provide
qoʻrqinch	fear
oʻrindiq	seat
yoʻlaklar	corridors
goʻng	fertilizer
qogʻozlar	papers
toʻxtatuvchi	deterrent
oʻxshashlik	similarity
koʻchatlar	seedlings
lugʻat	dictionary
koʻrsatdi	showed
sovgʻalar	gifts
oʻzgartirish	change
qoʻshimcha	appendix
ogʻirroq	heavier
toʻquvchilik	weaving
jagʻlari	jaws
qaldirgʻochlar	swallows
jagʻning	jaw
qoʻrqinchli	scary
oʻgʻri	thief
goʻzallik	beauty
doʻst	friend
olxoʻri	plum
magʻrurlik	pride
mugʻombir	artful
toʻplam	anthology
hasadgoʻylik	jealousy
oʻchirildi	deleted
oʻyinlar	games
choʻpon	shepherd
maʻnaviy	spiritually
toʻgʻrilik	accuracy
zigʻir	linen
yigʻilgan	collected
choʻkish	drowning
roʻyxatlari	lists
sovgʻa	gift
koʻp	several
bogʻbonlar	gardeners
toʻsatdan	abrupt
toʻrtinchisi	fourth
taʻlim	education
qoʻngʻiroq	bell
gʻorlar	caves
qoʻshimcha	affix
yorugʻ	alight
sugʻurtalovchi	insurer
yigʻadi	collects
ogʻiz	mouth
qoʻpol	bear
oʻlja	booty
joʻnatildi	shipped
soʻrang	ask
dimogʻdor	arrogant
qoʻshimcha	additional
qoʻrquv	fear
qargʻa	crow
gʻozlar	geese
toʻxtovsiz	abiding
oʻsadi	grows
yolgʻonchilar	liars
oʻyinchoqlar	toys
yigʻlamoq	cry
oʻpka	lung
ogʻirligi	weight
aʻzo	member
ogʻirliklar	weights
ilgʻor	advanced
doʻkonlari	shops
qoʻl	arm
yogʻingarchilik	precipitation
bogʻliq	depend
oʻtkazmalar	transfers
koʻrinmoq	appear
qoʻl	hand
sunʻiy	artificial
koʻrinish	aspect
paygʻambarlar	prophets
goʻzal	aesthetic
oʻng	right
koʻrsatmalar	instructions
oʻzgarish	change
ragʻbatlantirildi	encouraged
paygʻambar	prophet
koʻngildagidek	auspicious
koʻngilli	agreeable
qoʻshmoq	add
qoʻpol	rough
gʻamxoʻrlik	care
oʻqishlar	readings
oʻlish	die
koʻtarilish	climb
qurgʻoq	arid
yongʻoq	walnut
notoʻgʻri	amiss
toʻliqligi	completeness
choʻzmoq	stretch
goʻdak	child
oʻrtoqlar	comrades
toʻgʻri	direct
toʻsar	cutter
oʻtkir	acute
koʻnikmalar	skills
toʻyingan	saturated
qaygʻu	sorrow
oʻrta	average
toʻlov	pay
yoʻllar	roads
koʻplik	plural
oʻzgarmoq	alter
oʻylamoq	think
taʻminlash	supply
koʻl	lake
toʻyimli	nutritious
oʻrgatmoq	accustom
oʻzgarish	alteration
aygʻoqchi	agent
qoʻriqchi	guard
boʻyalgan	painted
yoʻqlik	absence
yongʻinlar	fires
soʻrarlar	ask
koʻrichak	appendix
koʻz	sight
sheʻrlar	poems
oʻjar	stubborn
bolgʻalar	hammers
boʻlim	section
uygʻun	appropriate
koʻrinadi	seem
oʻqish	reading
yoʻqolgan	lost
gʻalabalar	victories
koʻzlar	eyes
qoʻrquv	anxiety
choʻl	desert
goʻsht	meat
koʻngillilik	volunteering
yoʻl-yoʻriq	guidance
oʻynadi	played
boʻlinmalar	subdivisions
oʻynash	play
joʻshqin	ardent
qoʻzichoq	lamb
oʻq-dori	ammunition
oʻqilmagan	unread
soʻrish	absorption
toʻqson	ninety
poʻlat	steel
oʻquvchi	reader
qoʻmitalari	committees
magʻrur	arrogant
moʻrt	brittle
koʻpaytirildi	multiplied
gʻor	cave
oʻz-oʻzidan	spontaneously
koʻchish	migration
oʻtkazish	transfer
gʻarbiy	west
olgʻa	ahead
choʻzilgan	extending
oʻzaro	mutual
xoʻjayinlar	bosses
oʻzgartiradi	converts
taʻsirchan	impressive
sugʻorish	irrigation
toʻliq	full
gʻalati	weird
oʻt	grass
yongʻin	fire
qogʻoz	paper
qoʻydi	laid
sogʻlom	athletic
qirgʻiziston	kyrgyzstan
tugʻdirmaydi	pose
pogʻona	leap
bolgʻa	hammer
yalangʻoch	naked
oʻsgan	grown
yolgʻiz	alone
oʻzgartirildi	changed
qoʻshni	neighbor
merosxoʻrlar	heirs
olgʻa	forward
qirgʻoq	coast
doʻstona	amiable
koʻchalar	streets
qoʻlidan	could
toʻtiqush	parrot
oʻlim	death
yoʻlbars	tiger
kambagʻal	poor
feʻl	action
qoʻlda	manually
gʻazab	anger
yolgʻon	lie
oʻzgarishsiz	unchanged
koʻrishish	appointment
toʻlov	payment
soʻng	then
koʻmir	coal
choʻtka	brush
qoʻgʻirchoqlar	puppets
choʻkma	deposition
toʻrtburchak	rectangle
qoʻllaniladi	applied
oʻzgaruvchilar	variables
moʻyna	fur
qoʻrgʻoshin	lead
yoʻnaltirish	redirect
gʻamxoʻr	attentive
bogʻlamoq	associate
koʻprik	bridge
toʻplamlar	collections
soʻqmoqlar	cuttings
oʻyinchoq	toy
qoʻrqinchli	awful
boʻlak	apart
yoʻqolishi	disappearance
oʻtkirroq	sharper
gʻayratli	assiduous
magʻrurlik	arrogance
boʻron	storm
oʻtkazilayotgan	held
oʻzini	self
oʻyilgan	carved
qoʻlyozmasi	manuscript
gʻanim	adversary
qargʻalar	crows
yoʻlak	corridor
moʻminlar	believers
bugʻlanish	evaporation
bagʻishlangan	dedicated
oʻzimizni	ourselves
gʻayratli	ardent
bugʻdoy	wheat
xushboʻy	fragrant
qaygʻu	affliction
xudojoʻy	godly
koʻrsatkichlar	indicators
doʻstona	amicable
mehmondoʻstlik	hospitality
toʻdalar	gangs
xoʻroz	cock
gʻazab	anger
choʻntaklar	pockets
qoʻllab-quvvatlash	support
oʻrta	middle
agʻdarish	overthrow
shoʻrlanish	salinity
qoʻshilish	join
koʻp	much
kashtadoʻzlik	embroidery
boʻladi	will
yogʻoch	wood
choʻzish	stretch
doʻkon	shop
isteʻdodli	talented
soʻng	after
shoʻrva	soup
mugʻombirlik	affectation
oʻrganadi	learns
boʻronlar	storms
oʻrnatilgan	mounted
doʻstona	friendly
uygʻotdi	awakened
oʻrin	seat
oʻtin	wood
qoʻllanmalar	manuals
qovurgʻalar	ribs
oʻxshashlik	analogy
yogʻ	fat
oʻsimliklar	plants
koʻzgu	reflection
besoʻnaqay	awkward
boʻyoq	paint
koʻrgazma	exhibition
yorligʻi	label
magʻlubiyat	defeat
koʻpik	foam
yomgʻir	rain
gʻisht	brick
ochkoʻzlik	greed
yoʻnalish	direction
yigʻish	collection
dargʻazab	angry
toʻlqinlar	waves
koʻrsatuvlar	animations
oʻn	ten
oʻsmirlar	teens
bogʻdorchilik	gardening
yaqinlashish	approximate
kamsitish	abase
yigish	amass
shamollatish	air
singdirish	assimilate
kelishtirish	appease
qalbakilashtirish	adulterate
yopishish	adhere
ogohlantirish	admonish
bajarish	act
jonlantirish	animate
tarifi	definition
kamaytirish	abate
qita	continent
birlashtirish	aggregate
memorchilik	architecture
talimotlar	teachings
kelishtirish	arbitrate
soxtalashtirish	adulterate
konish	agree
uygotish	arouse
odatlantirish	accustom
moslashish	acclimatize
yarashtirish	appease
yaqinlashish	approach
sekinlatish	abate
yumshatish	alleviate
xastalanish	ail
moslashish	accommodate
umumlashtirish	summarize
yetishish	attain
bezatish	adorn
ishontirish	assure
terish	pick
qozonish	attain
marifat	enlightenment
orttirish	accumulate
qiynalish	agonize
taminot	supply
shimish	absorb
tezlashtirish	accelerate
yuksalish	ascend
qatiylik	persistence
tinchlantirish	appease
yigilish	aggregate
tortishish	argue
zavqlanish	admire
tariflaydi	describes
etiroflar	confessions
tenglashtirish	equate
kutish	await
qurollanish	arm
qala	castle
qozonish	acquire
biriktirish	attach
birlashtirish	add
bemani	absurd
bahslashish	argue
ayirish	subtract
tanishtirish	acquaint
orttirish	augment
davogarlar	claimants
siljitish	slip
firavn	pharaoh
saqlanish	avoid
manaviyat	spirituality
yigish	assemble
yigilish	assemble
kulish	laugh
jirkanish	abhor
kechikish	miss
yoq	wont
qitalar	continents
kamaytirish	alleviate
moslashish	accord
ananaviy	traditional
taminot	allowance
adashtirish	avert
ishontirish	argue
moslashish	adjust
titratish	agitate
jonlantirish	arouse
kuldirish	amuse
shoshilish	hurry
yopishtirish	attach
kiyintirish	clothe
chekinish	retreat
taziya	condolences
konish	accept
moslashtirish	adapt
birlashtirish	associate
tashlanish	attack
yetishish	achieve
tekshirish	audit
intilish	aspire
silkitish	agitate
obektivlik	objectivity
Obsesif Obsessive
Rejeneratsiya Regeneration
Vidalanadi Screwed
Primitivlar Primitives
Silgi Eraser
Tsivilizatsiyalar Civilizations
Ozgartiring Replace
Eğirme Spinning
Vilkalar Fork
Fizibilite Feasibility
Mennonit Mennonite
Korsika Corsica
Okçuluk Archery
Dekanlar Deans
Tanishishlik Acquaintance
Malvinalar Malvinas
Detoks Detox
Sinovchilar Testers
Klare Clare
Popuplar Popups
Tunerlar Tuners
Oluklar Grooves
Memor Architect
Sifiliz Syphilis
Patagoniya Patagonia
Siljiish Advance
Millisekundlarda Milliseconds
Oktav Octave
Kafeterya Cafeteria
Vashington Washington
Selülit Cellulite
Kantitativ Quantitative
Fobiya Phobia
Echimlar Solutions
Nudistlar Nudists
Barok Baroque
Amoksitsillin Amoxicillin
Koronado Coronado
Retseptlar Recipes
Transseksuallar Transsexuals
Qoshilish Adhere
Solucan Worm
Jenni Jenny
Uniforma Uniform
Tiner Thinner
Kapitallashtirildi Capitalized
Hostess Air
Vebkamera Webcam
Bulmacalar Puzzles
Subunitsiyalar Subunits
Subektiv Subjective
Taqsimlaish Allot
Oqlaish Acquit
Manipulyatsiya Manipulation
Dalgalanmalar Fluctuations
Martinik Martinique
Tolib-toshish Abundance
Barakalar Barracks
Fikstürü Fixture
Mantrani Mantra
Miyokardiyal Myocardial
Korelasyonlar Correlations
Byudjetlashtirish Budgeting
Pastadir Cycle
Mamografi Mammography
Tahqirli Abusive
Ahırlar Stables
Eksantrik Eccentric
Toptancılar Wholesalers
Nikol Nicole
Antikor Antibody
Dubay Dubai
Hisob-faktura Invoice
Goblenlar Tapestries
Kupa Mug
Epikor Epicor
Ordinat Ordinate
Adkinslar Adkins
Pulluk Plow
Futuristik Futuristic
Stressli Stressful
Jazy Jazzy
Filippliklar Philippians
Deko Deco
Anqara Ankara
Maskot Mascot
Tiklik Ascent
Sekanslar Sequences
Auktsionlar Auctions
Moyboyoqli Watermark
Eksportchilar Exporters
Intravenöz Intravenous
Adekvatlik Adequacy
Tutarlılık Consistency
Şaraphane Winery
Taltayish Antics
Narxlash Pricing
Fotokopisi Photocopy
Aylanmalar Turnovers
Rulonlarda Rolls
Lazzatlar Flavors
Intolerans Intolerance
Kriyojeniktir Cryogenic
Ezici Overwhelming
Kaşmir Cashmere
Qorqitish Appal
Kommunikator Communicator
Xorlanish Abasement
Qimirlaish Activate
Makarasi Reel
Proteaz Protease
Fluoksetin Fluoxetine
Mamurlar Administrators
Quyruqlari Tails
Konveks Convex
Kasbdosh Associate
Alacakaranlık Twilight
Poligonlar Polygons
Herbisid Herbicide
Baltimor Baltimore
Dumanlar Fumes
Bulletenlar Bulletins
Gerxard Gerhard
Uilyamson Williamson
Pishirgich Cooker
Kaloriyalar Calories
Lövhalari Boards
Fosforillanish Phosphorylation
Kümeleme Clustering
Maqullaydigan Affirmative
Shreddi Shredded
Papkasida Folder
Osteoartrit Osteoarthritis
Jokeylar Jockeys
Asetil Acetyl
Ağartıcı Bleach
Kobus Nightmare
Santrifüj Centrifugal
Tüylü Hairy
Yeaslar Yeas
Kuluçkahane Hatchery
Sugurtachilar Insurers
Sfenks Sphinx
Mumiya Mummy
Rafinari Refinery
Sorish Absorb
Hibiskus Hibiscus
Kastor Castor
Oryantal Oriental
Parklangan Parked
Hirsli Avid
Katarakt Cataract
Tijoratlashtirish Commercialization
Tezyordam Ambulance
Florid Fluoride
Transdüksiyon Transduction
Ortoqlarcha Amicable
Vanilya Vanilla
Taqillat Knock
Xaridlar Purchases
Patojenik Pathogenic
Venezuallan Venezuelan
Bangerlar Bangers
Turkuaz Turquoise
Destinasyonlar Destinations
Etimlar Orphans
Tasdiqlaish Acknowledge
Anekdot Anecdote
Taqiblar Persecution
Karlson Carlson
Toplaish Accumulate
Skecherlar Skechers
Hospiz Hospice
Transmembran Transmembrane
Karpal Carpal
Sanatkorona Artistic
Stiv Steve
Karver Carver
Ramifikatsiyalar Ramifications
Pelet Pellet
Haşhaş Poppy
Lazerjet Laserjet
Ma`lumot Information
Katlanmış Folded
Kopaytiring Multiply
Dallanma Branching
Kuratorlik Curatorial
Moloz Rubble
Kertenkele Lizard
Peçete Napkin
Tami Taste
Jabduqlar Harness
Masuliyatsiz Irresponsible
Formativ Formative
Kabarcıklar Bubbles
Ulaish Append
Tranzaksiya Transaction
Lomber Lumbar
Tailand Thailand
Kvarts Quartz
Erektsiya Erection
Ichakchasidagi Cord
Indüksiyon Induction
Oziqlantiruvchilar Feeders
Qozgatish Arouse
Mobilyalı Furnished
Yarımada Peninsula
Akura Acura
Qoralaish Accuse
Chidaish Abide
Takoz Wedge
Manosiz Meaningless
Raqobatdoshlik Competitiveness
Rohatlaning Relax
Bindirmalar Bindings
Indekslangan Indexed
Aktivlashtirish Activation
Infuziya Infusion
Motokros Motocross
Avizeler Chandeliers
Xameleyon Chameleon
Havodor Airy
Polinomlar Polynomials
Aerobus Airbus
Kasetlarda Cassette
Turgizish Arouse
Amatör Amateur
Galvanizlangan Galvanized
Kekkayishlik Arrogance
Amplifikator Amplifier
Stoklamoqda Stocking
Saunalar Saunas
Hinducha Chesapeake
Kempbell Campbell
Kartrij Cartridge
Krizislar Crises
Kollins Collins
Skeytbord Skateboard
Korsair Corsair
Payqaish Apprehend
Gamburg Hamburg
Boshashmasdan Loose
Kalvari Calvary
Yamaqlar Slopes
Murin Murine
Bruklin Brooklyn
Komaklashish Assist
Kristina Christina
Mikronesiya Micronesia
Auktsion Auction
Lyuter Luther
Avatarlar Avatars
Lehimleme Soldering
Rodyum Rhodium
Tripodlar Tripods
Bikerlar Bikers
Jamaika Jamaica
Fibrozis Fibrosis
Evolyutsiyalangan Evolved
Tsiklik Cyclic
Kombinatorylik Combinatorial
Ovqatlandi Eaten
Lobbi Lobby
Iridiyum Iridium
Redüktaz Reductase
Konv Conv
Nematlar Blessings
Spreylar Sprays
Maqullaish Applaud
Sertifikatlangan Certified
Jekson Jackson
Ketganimda Gone
Tasdiqlaish Affirm
Grenadinlar Grenadines
Vintlardek Screws
Oksidaz Oxidase
Kram Cram
Endojen Endogenous
Kemoterapi Chemotherapy
Vasiychi Guardian
Qattiqlashdi Hardened
Pentxaus Penthouse
Atanmamış Unassigned
Yelek Vest
Akadiya Acadia
Memor Architect
Xavoriy Apostle
Enzimatik Enzymatic
Çözgü Warp
Ilohiyotshunoslik Theology
Teras Terrace
Ötanazi Euthanasia
Motadil Moderate
Analoglar Analogs
Mamuriyat Administration
Multipleks Multiplex
Penguen Penguin
Raflar Shelves
Tombul Chubby
Zodyak Zodiac
Suitlar Suites
Ekumenik Ecumenical
Obektlar Objects
Chiplar Chips
Brahmalar Brahms
Vinç Crane
Komaklashish Aid
Skanerlashdi Scanned
Antijenler Antigens
Bioinformatika Bioinformatics
Mikrodalgalar Microwaves
Romatoid Rheumatoid
Bedaraklik Abeyance
Balast Ballast
Karlton Carlton
Illuziyalar Illusions
Mamuriyat Administration
Opportunistik Opportunistic
Jokey Jockey
Globalar Globes
Vizualizatsiya Visualization
Kortland Cortland
Kabuklar Shells
Iteratsiyalar Iterations
Jonson Johnson
Lümenler Lumens
Rampa Ramp
Tasischilar Founders
Muvofiqlashtiruvchilari Coordinators
Optimallashtirilgan Optimized
Hisoblaish Account
Hece Syllable
Prototiplar Prototypes
Polimeraz Polymerase
Mojizaviy Miraculous
Robinlar Robins
Barrellar Barrels
Reprintlar Reprints
Otoimmun Autoimmune
Siltang Flick
Fizyopatologiya Physiopathology
Mushukchalar Kittens
Pivochilar Brewers
Alglar Algae
Transportchi Transporter
Sheffild Sheffield
Tayyoragoh Airport
Nozul Nozzle
Skuba Scuba
Osilator Oscillator
Kanzas Kansas
Milflar Milfs
Singapur Singapore
Inhibisyonu Inhibition
Rupiyaliklar Rupees
Bollivud Bollywood
Arxangel Archangel
Fotoshop Photoshop
Kapsülleme Encapsulation
Kıvrım Curl
Stokgolm Stockholm
Aerodrome Aerodrome
Eter Ether
Bazil Basil
Mercan Coral
Vinsent Vincent
Filadelfiya Philadelphia
Blokbaster Blockbuster
Silika Silica
Subpudratchi Subcontractor
Pompalanadi Pumped
Xanna Hanna
Engish Overcome
Torna Lathe
Penguenlar Penguins
Kovboylar Cowboys
Gambiya Gambia
Kanguru Kangaroo
Demolar Demos
Sevuvchan Amorous
Glikoprotein Glycoprotein
Epoksi Epoxy
Ota-bobo Ancestor
Imzolar Signatures
Implantlar Implants
Smit Smith
Balladlar Ballads
Chayqaish Agitate
Mumbay Mumbai
Frensis Francis
Qadrlaish Appreciate
Otilganlik Bullet
Xorlash Abasement
Animiya Anaemia
Stiker Sticker
Reaktsiyalar Reactions
Pinellalar Pinellas
Keshlangan Cached
Ironi Irony
Maldivlar Maldives
Parchalaish Assimilate
Kanca Hook
Yuraklarni Hearts
Minimallashtirildi Minimized
Klit Clit
Silkitardi Shake
Hektor Hector
Akuamarin Aquamarine
Derleyici Compiler
Labirent Maze
Tomurcuklanma Budding
Tupurik Saliva
Menopoz Menopause
Istemolchi Consumer
Eksportchi Exporter
Kelebekler Butterflies
Prekursorlar Precursors
Golfchilar Golfers
Homologiya Homology
Klaudio Claudio
Hisobdorlik Accountability
Anoxronizm Anachronism
Hackerlar Hackers
Ostrogen Estrogen
Anjelika Angelica
Distribyutorlar Distributors
Kontratseptivlar Contraceptives
Spoylerlar Spoilers
Spekulyatsion Speculation
Yulka Pavement
Ipeksi Silky
Frezeleme Milling
Transduser Transducer
Primerlar Primers
Omilkor Able
Artishok Artichoke
Fanatikalar Fanatics
Klinisyen Clinician
Kamuflaj Camouflage
Shamrok Shamrock
Pechene Biscuit
Spammerlar Spammers
Benefitsiarlari Beneficiaries
Proaktiv Proactive
Elflar Elves
Karole Carole
Paramedik Paramedic
Oksitish Annoy
Tasirlanish Excite
Sızdırıldı Leaked
Rezervasyonu Booked
Heterojen Heterogeneous
Prehistorik Prehistoric
Inhibitörü Inhibitor
Yurisdiktsiyalar Jurisdictions
Moslaish Adapt
Floristlar Florists
Aktsiyador Shareholder
Ekson Exon
Palisadlar Palisades
Kontekst Context
Soraish Ask
Subversiyon Subversion
Kavisli Curved
Zayıflama Slimming
Handikap Handicap
Lityum Lithium
Onlaynda Online
Slavik Slavic
Sezdirish Allude
Nishonlang Celebrate
Eksilerini Cons
Balonlar Balloons
Ozlashtirish Adopt
Minigarnituralar Headphones
Proteomiklar Proteomics
Kursorlar Cursors
Yordamsiz Helpless
Kashshoflik Pioneering
Feministik Feminist
Disiplinlerarası Interdisciplinary
Hispaniklar Hispanics
Kambodja Cambodian
Genezi Genesis
Tıklanabilir Clickable
Blits Blitz
Promouterlar Promoters
Kaplumbağa Turtle
Etiborli Authoritative
Taqillatildi Knocked
Vasat Mediocre
Annuitetlar Annuities
Anaerobik Anaerobic
Konservatuar Conservatory
Etirozlar Objections
Miyalar Brains
Adaptor Adapter,
Disleksi Dyslexia
Izzattalab Ambition
Paragraflar Paragraphs
Sitokrom Cytochrome
Refrakterlik Refractory
Streyt Straight
Bazel Basel
Orkide Orchid
Istedod Aptitude
Quddus Jerusalem
Etiroz Objection
Iordaniya Jordan
Markazsizlashtirish Decentralization
Aktsiyadorlar Shareholders
Kajun Cajun
Tayinlaish Assign
Höyük Mound
Makaskor Scissor
Leksisnexis Lexisnexis
Balina Whale
Zopakda Zebra
Bariatrik Bariatric
Shimgichni Sponge
Portfellar Portfolios
Rejalashtiruvchilar Planners
Dublör Stunt
Mimarlar Architects
Heteroseksual Heterosexual
Revizyon Revision
Tompson Thompson
Rejalashtiruvchi Planner
Ipodlar Ipods
Xomilalik Fetal
Oxshatish Assimilate
Westminsterda Westminster
Mikrosistemalar Microsystems
Tsellyuloza Cellulose
Gijgijlaish Abet
Siklobenzaprin Cyclobenzaprine
Atriyal Atrial
Ekvivalentlar Equivalents
Prezumptsiyasi Presumption
Autsorsing Outsourcing
Zayıflatmak Weaken
Italyanca Italian
Paladyum Palladium
Valentin Valentine
Korteks Cortex
Hamak Hammock
Genomik Genomic
Menteşeli Hinged
Davlat-xususiy Public-private
Rezidentlik Residency
Pikaplar Pickups
Pervanel Propeller
Kontrplak Plywood
Karikaturalarning Cartoons
Etmishta Seventy
Adashish Aberration
Jorj George
Kapri Capri
Havoriylik Apostolic
Klonazepam Clonazepam
Lavanta Lavender
Brokkoli Broccoli
Doiymiy Abiding
Konst Const
Assimetriya Asymmetry
Subwooferlar Subwoofers
Olqishlash Applause
Rokchilar Rockers
Kozok Sweater
Skeytbording Skateboarding
Banditlar Bandits
Rulo Roll
Kanyon Canyon
Duglas Douglas
Chexoslovakiya Czechoslovakia
Ambargo Embargo
Menyular Menus
Ogriish Ache
Kob Cob
Infektsiyalari Infections
Psikososyal Psychosocial
Terapevtlar Therapists
Bohem Bohemian
Kilolu Overweight
Karsinom Carcinoma
Ekvalayzer Equalizer
Homeopatik Homeopathic
Kalvin Calvin
Boyaish Paint
Korp Corp
Ogayo Ohio
Faolx Activex
Shodlanish Admire
Manikyur Manicure
Etiqodlar Beliefs
Rezervasyonlar Reservations
Pembrokka Pembroke
Peletlar Pellets
Jeyms James
Shohliklar Kingdoms
Klivlend Cleveland
Ambitsiyalar Ambitions
Misyon Mission
Nikaragua Nicaragua
Huni Funnel
Virjiniya Virginia
Braket Bracket
Polatdir Steel
Antikorlar Antibodies
Daniyacha Danish
Elisabet Elisabeth
Hajmiof Sizeof
Dudmallik Ambiguity
Belgilang Tick
Klinton Clinton
Krank Crank
Efesliklar Ephesians
Pastorlar Pastors
Valtreks Valtrex
Karyolası Cot
Tercihen Preferably
Tickboxlar Tickboxes
Feribotlar Ferries
Lamel Radial
Freelancerlar Freelancers
Nostaljik Nostalgic
Diskontlangan Discounted
Insektisit Insecticide
Ponchik Donut
Yugoslaviya Yugoslavia
Atlaish Skip
Tasirlanmagan Unaffected
Topuvchilar Finders
Qalqonlarni Shields
Kanvas Canvas
Illinoys Illinois
Tetikleniyor Triggering
Transkriptlar Transcripts
Kronlar Crowns
Dilimlenmiş Sliced
Tamsayılar Integers
Sektoral Sectoral
Neoplazmalar Neoplasms
Serjio Sergio
Sarum Serum
Birikimli Cumulative
Cd-lar Cds
Sirganchiq Slippery
Kembrij Cambridge
Peçeteler Napkins
Kalıplanmış Molded
Detektivlar Detectives
Mesih Messiah
Rölativistik Relativistic
Barbekyu Barbecue
Infektsiyalangan Infected
Nashriyotchilar Publishers
Asetat Acetate
Detroyt Detroit
Nukl Nucl
Rulman Bearing
Tokalar Buckles
Granüler Granular
Katolikizm Catholicism
Kromatografi Chromatography
Krom Chromium
Sharhlaish Annotate
Kursor Cursor
Ege Aegean
Silindirlar Rollers
Periks Peroxide
Kelebek Butterfly
Oymalar Carvings
Kostryulkalar Cookware
Emusik Emusic
Taymerlar Timers
Zimbabve Zimbabwe
Bibariya Rosemary
Qollaish Apply
Anakart Motherboard
Kovanda Hive
Stublar Stubs
Homeopati Homeopathy
Megapiksellik Megapixel
Kraker Cracker
Ensest Incest
Yamalar Patches
Kalibex Calibex
Uilyams Williams
Albaniya Albania
Lenfosit Lymphocyte
Estoniya Estonia
Antillalar Antilles
Triggerlar Triggers
Kokpit Cockpit
Kashshoflar Pioneers
Buferlash Buffering
Sintaz Synthase
Laminatlangan Laminated
Patrullar Patrols
Liturgi Liturgy
Megabaytlar Megabytes
Faul Foul
Tuyulish Appear
Xorvatiya Croatian
Biftek Steak
Bungalov Bungalow
Flamenko Flamenco
Salınımlar Oscillations
Inklüzyonlar Inclusions
Neoplazma Neoplasm
Galon Gallon
Torasik Thoracic
Rozetkalari Sockets
Lezbiyen Lesbian
Pijama Pajamas
Teodor Theodore
Kiosklar Kiosks
Fakslashtirilgan Faxed
Treylerlar Trailers
Realtonlar Realtones
Pitsburg Pittsburgh
Istedodlar Talents
Ultrastrüktür Ultrastructure
Tiroid Thyroid
Yalangoyoqlik Barefoot
Karasal Terrestrial
Narvonlarini Stairs
Kibrli Arrogant
Tugralgan Chopped
Sembolizm Symbolism
Orgazmlar Orgasms
Biomedikal Biomedical
Qichimish Itching
Limerik Limerick
Ortalamalar Averages
Aspiratsiya Aspiration
Muvofiqlaish Adapt
Zahiralashlar Backups
Jirkantiradigan Abominable
Vang Wang
Ruterford Rutherford
Karbongidrat Carbohydrate
Dasturlashtirilgan Programmed
Sochingizni Shave
Mansarda Attic
Qalalar Castles
Jirk Jerk
Solihlik Righteousness
Çapa Anchor
Raylar Rails
Nafratlanish Hate
Paspaslar Mats
Asetaminofen Acetaminophen
Mashalalar Torches
Transduserlar Transducers
Savolnoma Questionnaire
Adaptorlar Adapters
Zindonlar Dungeons
Katlama Folding
Subklasslar Subclasses
Aggregatsiya Aggregation
Eskirmaydigan Ageless
Romatologiya Rheumatology
Qattiqlashuv Hardening
Eslatmalar Notes
Kennet Kenneth
Uterin Uterine
Gonduras Honduras
Taytalar Tights
Ranjitish Afflict
Ranjid Rancid
Troyanlar Trojans
Assortiment Assortment
Muzlatgichlar Refrigerators
Fişler Plugs
Antimikrobiyal Antimicrobial
Shakarlamalar Confectionery
Kopaytirish Augment
Polarizatsiya Polarization
Petitsionerlar Petitioners
Bükme Bending
Chorrahalar Crossroads
Ilminujum Astrology
Kepçe Bucket
Artefakt Artifact
Mount Mount
Finalistlar Finalists
Komando Commando
Lenoks Lenox
Ajitasyon Agitation
Mantarlar Fungi
Saten Satin
Iblislar Demons
Toptancı Wholesaler
Petitsiyalar Petitions
Arsinik Arsenic
Vebster Webster
Akorlari Chords
Barret Barrett
Interoperativlik Interoperability
Manik Manic
Orgiyalar Orgies
Safir Sapphire
Ovchilarni Hunters
Hybridizatsiya Hybridization
Skeytbordlar Skateboards
Yashovchisi Resident
Ukraynaca Ukrainian
Stiven Stephen
Shongin Diving
Kondansatörler Capacitors
Sarkaç Pendulum
Vilkasi Plug
Kaskadlar Cascades
Gitarlar Guitars
Otopsi Autopsy
Krakerlar Crackers
Evangelizm Evangelism
Kanberra Canberra
Aktüatörler Actuators
Shifon Chiffon
Teeth Teeth
Anastaziya Anastasia
Kutyapmiz Expect
Süspansiyonlar Suspensions
Psixotik Psychotic
Okunabilirlik Readability
Avtobiografiya Autobiography
Antikor Antibody
Transkript Transcript
Eğimli Inclined
Koylar Bays
Istiridye Oysters
Antidepressantlar Antidepressants
Kristof Christoph
Dispenserlar Dispensers
Jinsiylik Sexuality
Rejenerativ Regenerative
Heuristik Heuristic
Bromit Bromide
Otistik Autistic
Popkorn Popcorn
Flamancha Flemish
Molchilik Abundance
Matraslar Mattresses
Matkaplar Drills
Haçlılar Crusaders
Kohort Cohort
Akupunktur Acupuncture
Polarlik Polarity
Topraklama Grounding
Hizalamak Align
Afgoniston Afghanistan
Kekik Thyme
Marinalar Marinas
Vitralar Showcases
Istifleme Stacking
Melankoli Melancholy
Shtammlar Strains
Bloklandi Blocked
Nikelodeon Nickelodeon
Maydanoz Parsley
Buldoglar Bulldogs
Fitnes Fitness
Flütler Flutes
Davolar Claims
Kamelot Camelot
Avionika Avionics
Masonik Masonic
Maqullaish Accede
Mushtlari Fists
Vana Valve
Eskortlashdi Escorted
Telefoto Telephoto
Mitokondriyal Mitochondrial
Lotlar Lots
Kechikishlar Delays
Atıcı Shooter
Baholovchilar Appraisers
Patogenlar Pathogens
Istaish Want
Harakatlaning Move
Mikroprosessori Microprocessor
Anjelina Angelina
Konjugat Conjugate
Kayaklar Skis
Koksov Asthma
Ishqalaish Rub
Yengiltak Airy
Fotovoltaik Photovoltaic
Klitoris Clitoris
Hayratlantirish Astonish
Lenfoma Lymphoma
Simulyator Simulator
Chalgitish Avert
Shoklar Shocks
Lokali Tavern
Iktidarsizlik Impotence
Kronograf Chronograph
Evoh Alas
Karol Carol
Hurda Scrap
Tsikllari Cycles
Spurslar Spurs
Havoriylar Apostles
Kramplar Cramps
Chanqaish Ache
Inonish Ascertain
Hipotetik Hypothetical
Antologiyalar Anthologies
Goril Gorilla
Uyalgan Ashamed
Boncuklar Beads
Kozmopolit Cosmopolitan
Inverteri Inverter
Tasdiqlang Confirm
Inhibitörleri Inhibitors
Bonuslar Bonuses
Xertz Hertz
Taajublantirish Amaze
Kompendium Compendium
Dopamin Dopamine
Bungalovlar Bungalows
Leksis Lexis
Tendentsiya Tendency
Hoppoz Anthrax
Talimot Doctrine
Sochsiz Hairless
Seramika Ceramic
Conditioning Air
Manikürler Manicures
Bloker Blocker
Siyohrang Purple
Gözenekli Porous
Xelsinki Helsinki
Mariya Maria
Energizator Energizer
Sandviçlar Sandwiches
Saskatchevan Saskatchewan
Matris Matrix
Konikish Acclimatize
Serobgarchilik Abundance
Sarqasm Sarcasm
Fibromiyalji Fibromyalgia
Qorqinch Alarm
Qorishtirish Amalgamate
Kondominyumlar Condominiums
Atıcılar Shooters
Makarthur Macarthur
Maskeleme Masking
Nafosatli Aesthetic
Kafataslari Skulls
Becerdin Fucked
Hap Pill
Dantel Lace
Xohlaish Ask
Antarktida Antarctica
Makroslar Macros
Yoğuşma Condensation
Qulflar Locks
Gurme Gourmet
Kontekstlar Contexts
Palyatif Palliative
Rezervasyon Reservation
Identifikatorlari Identifiers
Bagishlanish Dedication
Qoramagiz Brunette
Kinazlar Kinases
Qamaish Arrest
Kovaryans Covariance
Chashka Cup
Herbisidlar Herbicides
Madalyon Medallion
Spelllar Spells
Tortinchoq Abashed
Epinionlar Epinions
Intervalgacha Intermittently
Sokish Abuse
Zaxiralash Backup
Playofflar Playoffs
Sidr Cedar
Tayland Thailand
Kruiz Cruise
Tayinlaish Appoint
Klaudiya Claudia
Prologiya Prologue
Flibs Philips
Lineer Linear
Avtokrat Autocrat
Rutinlar Routines
Konstable Constable
Elektrchilar Electricians
Kadmiyum Cadmium
Blogosfera Blogosphere
Nafaqaxor Retiree
Jeneva Geneva
Nikelback Nickelback
Gyote Goethe
Meraklıları Enthusiasts
Astoriya Astoria
Spoyler Spoiler
Drezden Dresden
Disfunktsiya Dysfunction
Shaftalar Shafts
Epiteliya Epithelium
Kehribar Amber
Greft Graft
Ragbi Rugby
Antaliya Antalya
Maqullaish Approve
Konventsiya Convention
Frantsiya France
Orgat Teach
Chikago Chicago
Koventriya Coventry
Eczane Pharmacy
Masuliyat Responsibility
Taktikalar Tactics
Uzunlamasına Longitudinal
Kanyonlar Canyons
Kelishilish Arrange
Yomonlashtirish Aggravate
Ankraj Anchorage
Jeneratör Generator
Korfu Corfu
Frederik Frederick
Korbin Corbin
Uluglaish Aggrandize
Dekal Decal
Genomlar Genomes
Samsonit Samsonite
Mozambik Mozambique
Metastatik Metastatic
Nafratlanish Abhor
Arxivlangan Archived
Avtofokus Autofocus
Klipart Clipart
Tasmaniyalik Tasmanian
Portlend Portland
Sindikatsiya Syndication
Xatchoplar Bookmarks
Obekt Object
Doljin Cinnamon
Kolorektal Colorectal
Kupalar Mugs
Markazsizlashtirildi Decentralized
Zaifliklar Weaknesses
Tutarsızlıklar Inconsistencies
Tashvishlantirish Ail
Ejekulyatsiya Ejaculation
Püskürtülür Sprayed
Anagramma Anagram
Kalgari Calgary
Mikrofiber Microfiber
Infektsion Infection
Telemeditsina Telemedicine
Kayışlar Straps
Çeşniler Condiments
Narniya Narnia
Traektoriyasi Trajectory
Bombardimonchilar Bombers
Yaxshilaish Ameliorate
Sanatkorlik Artistry
Konteynırlar Containers
Sincap Squirrel
Garovgirlar Pirates
Benefitsiariy Beneficiary
Plutonyum Plutonium
Rozet Badge
Taqiqlaish Prohibit
Mahkamlaish Attach
Ayçiçeği Sunflower
Indükleyiniz Induce
Yasemin Jasmine
Mikser Mixer
Barajlar Dams
Topikal Topical
Chinnigullar Cloves
Senaryolar Scenarios
Soslar Sauces
Kovanlar Hives
Nukleotitler Nucleotides
Treyler Trailer
Farmakol Pharmacol
Irritativ Irritable
Limuzinlar Limousines
Detoksifikatsiya Detoxification
Fakslar Faxes
Vajetaryen Vegetarian
Portaj Portage
Audionlar Auditions
Yalaish Lick
Dişhekimleri Dentists
Dejenerasyon Degeneration
Kalıplama Molding
Qarorlashtirish Assent
Problar Probes
Maqullash Approval
Konkordiya Concordia
Larvalar Larvae
Mikserlar Mixers
Etiketli Tagged
Alyanslar Alliances
Kolombo Colombo
Elektra Electra
Lyuksemburg Luxembourg
Importchilar Importers
Takidlaish Accentuate
Platsebo Placebo
Tebeşir Chalk
Korel Corel
Byzantin Byzantine
Sherlok Sherlock
Renderlash Rendering
Kollin Collin
Sovutgich Refrigerator
Uilyamsburg Williamsburg
Innovatsiyalar Innovations
Taqdimotchilar Presenters
Koza Cocoon
Pishloqlar Cheeses
Lubbok Lubbock
Flört Flirting
Tasdiqlaish Assent
Kolossiyaliklar Colossians
Xushyoqishni Sympathy
Plazmid Plasmid
Texnol Technol
Simulyatsiyalar Simulations
Iteratsiya Iteration
Semitizm Semitism
Hidra Hydra
Sapmalar Deviations
Bulaniq Blurred
Sinxronlashtirilgan Synchronized
Soket Socket
Rustik Rustic
Megapikselliklar Megapixels
Sayohatchiga Traveler
Homolog Homologous
Kromatin Chromatin
Akupunktur Acupuncture
Latviya Latvian
Kapsüller Capsules
Nomod Nomad
Aktuator Actuator
Yukxalta Bag
Transgenik Transgenic
Palapartishlikdan Waterfall
Sörveyör Surveyor
Rohibalar Nuns
Taminlaish Assure
Burgerlar Burgers
Hizalama Alignment
Konsentrasiyalari Concentrations
Skorchi Scorer
Madelein Madeleine
Gatorlar Gators
Balistik Ballistic
Haddelenmiş Rolled
Monoksit Monoxide
Kuzatasiz Perspective
Tantiqlik Antics
Rampalar Ramps
Salyangoz Snail
Toleranslar Tolerances
Korozif Corrosive
Yosemit Yosemite
Radyoterapi Radiotherapy
Astrolojik Astrological
Xatolik-yanglishish Anachronism
Kopaytirish Aggrandize
Emulyator Emulator
Inspiratsiyalari Inspirations
Afishada Poster
Biriktirma Attachment
Taqsimlaish Apportion
Invaziv Invasive
Gradyanlar Gradients
Frantsisko Francisco
Annuitet Annuity
Eskalatsiya Escalation
Toplaish Amass
Kalçalar Hips
Taqsimlaish Allocate
Xevron Hebron
Anorak Anorak
Abartılı Exaggerated
Kapsül Capsule
Tayinlang Assign
Buyruqboz Authoritarian
Resepsiyonist Receptionist
Blenderlar Blenders
Manifoldlar Manifolds
Palsi Palsy
Etiborsizlik Apathy
Pulslar Pulses
Erkalanish Antics
Kopenhagen Copenhagen
Traektoriyalar Trajectories
Stokastik Stochastic
Aksessuar Accessory
Koaksiyal Coaxial
Ochuvchilar Openers
Emiliya Emilia
Qumqogoz Abrasive
Solaryum Solarium
Integratorlar Integrators
Tortinchoq Ashamed
Oqadilar Mites
Entsiklopediyalar Encyclopedias
Hiper Hyper
Ierarxiyalar Hierarchies
Toldirish Annex
Sevmaydigan Averse
Norvich Norwich
Spagetti Spaghetti
Korbett Corbett
Subsidiyalashtirilgan Subsidized
Farmakokinetikasi Pharmacokinetics
Maskeli Masked
Marikopa Maricopa
Bej Beige
Slaydlar Slides
Neptun Neptune
Kestirib Hip
Sanatkorlar Artists
Vinyet Vignette
Insidansı Incidence
Vorteks Vortex
Ogirlashtirish Aggravate
Izzat-nafs Ambition
Teraslar Terraces
Guildfordda Guildford
Dulut Duluth
Mikroarray Microarray
Bulgariya Bulgaria
Elektrotlar Electrodes
Kalkulyator Calculator
Xorlaish Abase
Aparteidda Apartheid
Zambaklar Lilies
Ananalari Traditions
Keniya Kenya
Transplantlar Transplants
Tablatura Tablature
Dehidrogenaz Dehydrogenase
Mailerlar Mailers
Xohlaish Aspire
Bifteklar Steaks
Kistlar Cysts
Sloveniya Slovenia
Harmonik Harmonic
Multidisipliner Multidisciplinary
Qoshuv Addition
Obro-etibor Prestige
Yasamalik Affectation
Eksenli Axial
Eczaneler Pharmacies
Maruzachi Speaker
Ichuvchilar Drinkers
Bodomlar Almonds
Subpudratchilar Subcontractors
Qudos Kudos
Podkastlar Podcasts
Nöronal Neuronal
Yondirgichlar Burners
Kampuslari Campuses
Xushxabarchi Evangelist
Harmonika Harmonica
Ingredientlar Ingredients
Lehim Solder
Murvat Bolt
Shaxsiylashtirish Personalization
Bemanilik Nonsense
Xarris Harris
Kapsüllenmiştir Encapsulated
Glutatyon Glutathione
Fridrix Friedrich
Pulsli Pulsed
Lob Lobe
Boshatish Absolve
Kıvırma Curling
Kadife Velvet
E-pochta Email
Ranjitish Annoy
Fellar Verbs
Ovoragarchilik Ado
Tirmashish Climb
Kümelenmiş Clustered
Blokerlar Blockers
Alloh Allah
Nostalji Nostalgia
Optimizator Optimizer
Avanslar Advances
Penseler Pliers
Floplar Flops
Tanzaniya Tanzania
Parlatilgan Polished
Mezoteliyoma Mesothelioma
Baharatlı Spicy
Lobbist Lobbyist
Jeller Gels
Histerektomiya Hysterectomy
Kreta Crete
Emperyalizm Imperialism
Fraktsiyalar Fractions
Heterojenlik Heterogeneity
Klonlangan Cloned
Fritöz Fryer
Usulsüzlükler Irregularities
Vankuver Vancouver
Kantsler Chancellor
Fosfataz Phosphatase
Klarks Clarks
Kertenkeleler Lizards
Hidroksi Hydroxy
Jamgarish Accumulate
Monika Monica
Monako Monaco
Zarf Envelope
Fermuar Zipper
Kimbol Kimball
Axiyom Axiom
Qaraish Attend
Titanik Titanic
Faullar Fouls
Ambiyans Ambience
Simulyatorlar Simulators
Hamiltoniyalik Hamiltonian
Indüklendi Induced
Griffithlar Griffiths
Norvegiya Norwegian
Izohlaish Annotate
Kaltaklangan Beaten
Takidlaish Affirm
Zoravonliksiz Nonviolent
Ekstruzyon Extrusion
Normallashtirildi Normalized
Vaktsinalar Vaccines
Kruizlar Cruises
Kaplumbağalar Turtles
Ilgarilaish Advance
Drayvlar Drives
Vatikan Vatican
Ovulyatsiya Ovulation
Oukland Auckland
Galiley Galileo
Metadon Methadone
Aşındırıcı Abrasive
Veb-translatsiya Webcast
Aralashtiramiz Mix
Rotorlar Rotors
Eczacı Pharmacist
Konturlangan Contoured
Finlandiya Finland
Akne Acne
Arizachi Applicant
Siyanür Cyanide
Rulmanlar Bearings
Laminat Laminate
Kapitalizatsiya Capitalization
Dizaynlashtirilgan Designs
Mojiza Miracle
Regulyatorlar Regulators
Anakartlar Motherboards
Armeniya Armenia
Semptomatik Symptomatic
Kist Cyst
Hepburnu Hepburn
Vizyoner Visionary
Kengaytmalar Extensions
Kaldıraç Leverage
Edmondlar Edmonds
Ölçeklenebilirlik Scalability
Floresans Fluorescence
Frantsuzcha French
Jest Gesture
Skameykalar Benches
Kristofer Christopher
Sinxronizatsiya Synchronization
Raqamlashtirilgan Digitized
Vaover Andover
Benni Benny
Dekor Decor
Bolishish Apportion
Silindir Cylinder
Tekila Tequila
Chaqnoq Alight
Mojizalar Miracles
Shohtomir Aorta
Koax Coax
Teriyerlar Terriers
Fikstürler Fixtures
Diyaliz Dialysis
Istedod Talent
Webmasterlar Webmasters
Tasdiqlaish Authorize
Lasan Coil
Oftalmik Ophthalmic
Tavla Backgammon
Keshlar Caches
Shikoyatchi Complainant
Yuanga Yuan
Bioetika Bioethics
Ölçeklenebilir Scalable
Nigeriya Nigeria
Islomobod Islamabad
Kolokyum Colloquium
Vitrin Showcase
Styuardessa Hostess
Konsollar Consoles
Sincaplar Squirrels
Istemolchilar Consumers
Xop Okay
Tasdiqlaish Approve
Zarflar Envelopes
Farasingiz Fancy
Önlükler Aprons
Kasperskiy Kaspersky
Parfyum Perfume
Feribot Ferry
Yotoqlari Beds
Brifing Briefing
Puro Cigar
Puding Pudding
Yutudu Swallowed
Bloglash Blogging
Kondanser Condenser
Pro-hayot Pro-life
Anormallikler Abnormalities
Stikerlar Stickers
Kllr Cllr
Sansürsüz Uncensored
Tornavida Screwdriver
Bluzka Blouse
Interkom Intercom
Elyaflar Fibers
Kinaz Kinase
Ayblaish Accuse
Klarkson Clarkson
Orleanlarda Orleans
Boncuk Bead
Ogirlaish Abduct
Reaktsiya Reaction
Keladir Shall
Projektör Projector
Omurgasızlar Invertebrates
Subklass Subclass
Budapesht Budapest
Öğütücüdür Grinder
Mikrodalga Microwave
Hayajonlangan Excited
Qohira Cairo
Elektrikchi Electrician
Grafikalar Graphics
Haçlılık Crusade
Anekdotlar Anecdotes
Menteşe Hinge
Masum Artless
Regentlar Regents
Pirsinglar Piercings
Disneylend Disneyland
Jeyson Jason
Telekonferans Teleconference
Qargaish Abuse
Ovaryan Ovarian
Qichiydigan Itchy
Interlökin Interleukin
Dublikatlar Duplicates
Ikonik Iconic
Vaginalar Vaginas
Sindikatlashgan Syndicated
Panterlar Panthers
Salgınlar Outbreaks
Stripperlar Strippers
Taminlanish Accommodate
Asansör Elevator
Orkinos Tuna
Jakobson Jacobson
Chochitish Appal
Tamsayı Integer
Tutarsızlık Inconsistency
Semitik Semitic
Buxgalter-ekspert Accountant
Ogritish Ail
Divanlar Sofas
Uyaladigan Ashamed
Detarjen Detergent
Orientatsiya Orientation
Gomoseksualizm Homosexuality
Toksisit Toxicity
Dumalar Dumas
Istifleyici Stacker
Panelistlar Panelists
Yonca Clover
Davlumbazlar Hoods
Aldatildi Deceived
Oflaynda Offline
Portativligi Portability
Palyaço Clown
Royaller Royals
Interaktivlik Interactivity
Kennedi Kennedy
Küvet Bathtub
Takrorlang Repeat
Iterativ Iterative
Bamperlar Bumpers
Kurator Curator
Şömineler Fireplaces
