yönetmenler	directors
yoksunluk	deprivation
pantolon	trousers
kutsallık	holiness
tonoz	vault
duyu	sense
öncel	predecessor
zehirleme	poisoning
bağlayıcı	binding
harman	blend
rahatsız	uncomfortable
arnavutça	albanian
renkler	colors
çalışmalar	studies
stdout'u	stdout
mazlum	oppressed
koydu	laid
ekmekler	breads
komiteler	committees
keşif	discovery
harç	mortar
yapay	artificial
koştu	ran
sahipleri	owners
projeksiyon	projection
kardeşlik	brotherhood
doğaüstü	supernatural
önek	prefix
ütüler	irons
uyarmak	warn
incelikle	gracefully
test	test
sürtme	rubbing
soyluluk	nobility
barkod	barcode
çevirmen	translator
anahtarlamalı	switched
kişilerarası	interpersonal
sahraaltı	sub-saharan
temizce	neatly
ortogonal	orthogonal
sıkma	squeezing
geliştirici	developer
asal	prime
severek	fondly
bağışlanan	donated
yayınlanmamış	unpublished
emperyalizm	imperialism
destekçileri	supporters
dezavantajları	disadvantages
mutantlar	mutants
sünnet	circumcision
kasırga	hurricane
seçin	select
üstlenilen	undertaken
batma	sinking
sizin	your
savaşçı	warrior
merhum	deceased
değeri	value
saymak	count
ereksiyon	erection
madenci	miner
bağımlılık	dependence
doldurulmasına	refills
dayatma	imposition
uçuş	flight
süre	while
bombeyli	belleville
yemek	eat
kovuşturma	prosecution
ramazan	ramadan
eklemli	articulated
avokado	avocado
eller	hands
sergiler	exhibitions
melezler	hybrids
nörolojik	neurological
kuyruklar	queues
kaplumbağa	turtle
parçacıklar	particles
optometri	optometry
korelasyonlar	correlations
şiddetle	strongly
sazan	carp
asist	assists
oda	room
baba	father
regülatör	regulator
sağlanan	provided
cephane	ammunition
huzursuz	restless
çamurcun	teal
hata	error
yöneten	governing
bağırma	yell
dönek	renegade
dizüstü	laptop
buğday	wheat
çiviler	nails
mikelanj	michelangelo
senatör	senator
elli	fifty
muhtemelen	probably
koltuk	seat
göksel	heavenly
ikna	persuasion
doymuş	saturated
marangoz	carpenter
sağ	right
ishal	diarrhea
tüm	all
tamircilik	tinker
iğ	spindle
tüketilen	consumed
afyon	opium
eşekarısı	hornet
botanik	botanical
sergi	exhibition
vurgular	highlights
ıdc	idc
sayfa	page
düet	duet
tütün	tobacco
etkili	effective
olsun	get
yeterli	enough
feromon	pheromone
morbidite	morbidity
koçan	stub
tümevarımsal	inductive
fosfat	phosphate
anomali	anomaly
çağdaş	contemporary
içine	into
öğretici	instructive
alkollü	alcoholic
müteahhitler	contractors
gelenek	tradition
resimler	pictures
referandum	referendum
pizzacı	pizzeria
sigortacı	insurer
marifet	ingenuity
klan	clan
termodinamik	thermodynamics
daha	more
çekler	checks
failler	perpetrators
örme	knitting
endometriyozis	endometriosis
gelen	incoming
kumral	auburn
hannover	hanover
miyokardiyal	myocardial
havlu	towel
karşılaştırır	compares
zamanlama	timing
telli	wired
dönüştürücüler	converters
seçim	selection
varyantları	variants
rasyonellik	rationality
ölümler	deaths
bağlantıları	connections
calüt	goliath
komiser	commissioner
erişir	accesses
hasta	patient
ıraksak	divergent
kilit	lock
akışı	stream
prototipleme	prototyping
ataerkil	patriarchal
somun	nut
vızıltı	buzz
kendisi	itself
izolasyon	isolation
teriyeri	terriers
içme	drinking
alıntılar	excerpts
monofonik	monophonic
kolyeler	necklaces
itibar	reputation
tüp	tube
teras	terrace
doğrusal	linear
ateş	fire
mezuniyet	graduation
otobüs	bus
apandis	appendix
demir	iron
poliüretan	polyurethane
isteyerek	willingly
kredibükreş	lends
fiyat	price
finlandiya	finland
dükler	dukes
notasyonu	notation
bulutlar	clouds
sekreter	secretary
anlamsal	semantic
şort	shorts
menşeli	originating
yönlendirir	directs
alımları	purchases
elçi	envoy
mülkiyet	property
devamsızlık	discontinuity
çelişkili	contradictory
küvet	tub
üniversite	university
otoimmün	autoimmune
tablatura	tablature
şimşek	lightning
kaygan	slippery
misyon	mission
zemin	floor
beceriyor	banging
ulaşan	reaching
makul	reasonable
ihracatçı	exporter
tahviller	bonds
kâğıtlar	papers
oylama	voting
peptidler	peptides
kongo	congo
ünsüz	consonant
sırıtış	grin
kaniş	poodle
spanyel	spaniel
güller	roses
tabaklanmış	tanned
böbrek	kidney
kırık	broken
avrupa	european
hürmetle	respectfully
vanilya	vanilla
dans	dance
kaptanlar	captains
dedikodu	gossip
biletlendirme	ticketing
dama	checkers
sefer	expedition
analog	analogue
deklarasyon	declaration
giderek	increasingly
nedenleri	reasons
berraklık	clarity
kadar	until
mesafe	distance
açılar	angles
sedimantasyon	sedimentation
mülteciler	refugees
payandalar	struts
garip	strange
eleştirmen	critic
kıçta	aft
teslim	delivery
üçüncü	third
karaca	roe
titreşen	vibrating
becerdin	fucked
yaralanmalar	injuries
vergilendirilmiş	taxed
karşılıklı	mutual
sualtı	underwater
komplikasyon	complication
çiftlikleri	farms
albay	colonel
hatırlatmalar	reminders
iğneleyici	sarcastic
klamidya	chlamydia
pus	haze
kitleri	kits
lütfen	please
kesintiler	deductions
sistematik	systematic
genel	general
sinyalizasyon	signaling
onikinci	twelfth
uzakta	away
etkisi	effect
megapiksel	megapixel
kutulu	boxed
aromatik	aromatic
boş	null
gözleri	eyes
miki	mickey
kazan	boiler
italyan	italian
buluntular	finds
söylemek	say
tevdi	deposited
kısıtlar	restricts
mikrofilm	microfilm
güvercinler	pigeons
güneş	sun
oh	oh
protestolar	protests
karın	abdomen
asmalar	vines
terkedilmiş	abandoned
çakıl	gravel
hidroklorid	hydrochloride
öfke	anger
birmanyalı	burmese
solaryum	solarium
mumya	mummy
krikolar	jacks
dumanlar	fumes
işleyicileri	handlers
öncelikler	priorities
bask	basque
başarısızlık	failure
flaşörleri	flashers
yutma	swallowing
kriyojenik	cryogenic
odak	focus
gözlemciler	observers
kristal	crystal
uzunluk	length
ergonomi	ergonomics
kovuşturmaları	prosecutions
sunumlar	presentations
kovaladı	chased
şehvet	lust
raket	racket
sağlık	health
hedefleyen	aiming
kraliçeler	queens
çikolata	chocolate
kişi	person
seviye	level
sitrin	citrine
muhteşem	spectacular
elbise	dress
zümrüt	emerald
kısmi	partial
tonik	tonic
bükreş	bucharest
çarpışmalar	collisions
frekansları	frequencies
inanılmaz	unbelievable
büyükçe	sizeable
sokaklar	streets
fosfataz	phosphatase
içinde	in
radyoterapi	radiotherapy
yetim	orphan
birçok	many
çavdar	rye
ortodoks	orthodox
bulmaca	crossword
yetenekli	able
tıklatma	rap
tövbe	repentance
toptancı	wholesaler
tensör	tensor
konak	mansion
makas	scissors
kısıtlayan	restricting
yazım	spelling
sulama	irrigation
süslemek	decorate
rahip	priest
yöneticileri	managers
düzlem	plane
çeşitlilik	diversity
sirk	circus
kronograf	chronograph
sfenks	sphinx
uyumlu	compatible
nöro	neuro
indirim	discount
yön	direction
telekomünikasyon	telecommunication
çalışma	study
vampir	vampire
bakan	minister
ileri	forward
milletler	nations
enlem	latitude
denetçiler	auditors
kistler	cysts
menzil	range
var	has
elastikiyet	elasticity
çıkış	exit
çoğaltmak	reproduce
bilezik	bracelet
dll'ler	dlls
çadır	tent
iss'ler	isps
riko	rico
havalimanı	airport
gündönümü	solstice
birleşme	merger
psişik	psychic
kuyumcu	jeweler
gıdıklamak	tickle
sezar	caesar
zemin	ground
olabilir	might
derinlemesine	in-depth
mangaları	squads
kadın	women
okunmamış	unread
yarar	benefit
rpm'leri	rpms
şerhler	commentaries
melez	hybrid
kromatin	chromatin
istemciler	clients
kabare	cabaret
şeftaliler	peaches
yukarı	up
giymek	wear
konektörü	connector
çıkartmalar	stickers
deney	experiment
yolculuklar	journeys
deve	camel
çap	diameter
gerçek	real
temizleyici	cleaner
cömertlik	generosity
haydutlar	bandits
eşitlik	equality
yıllık	yearly
telgraf	telegram
elektrostatik	electrostatic
okçu	archer
garaj	garage
denizaltılar	submarines
selamlar	greetings
yangın	fire
istişareler	consultations
başbakanlık	premiership
gelmeden	arriving
etik	ethic
formlar	forms
temel	basic
koka	coca
yamalar	patches
icat	invent
durgun	stagnant
eğitici	educational
belgrat	belgrade
dava	case
sülfat	sulfate
dik	perpendicular
olgunlaşır	matures
jamaika	jamaica
turizm	tourism
uzatmak	extend
koruyarak	preserving
konuşur	speaks
ölçek	scale
varşova	warsaw
grafit	graphite
taahhüt	undertaking
yutmak	swallow
molekül	molecule
otuz	thirty
tıp	medicine
bağımsızlar	independents
kilitli	locked
çay	tea
gerçekçi	realistic
ekonomiklik	affordability
formülasyonlar	formulations
ahit	testament
jüri	jury
lisans	license
eğitim	education
öfkeyle	angrily
jeoteknik	geotechnical
deşarj	discharge
acılık	bitterness
ilerici	progressive
gözlemek	observe
piercing	piercings
stresli	stressful
korsan	pirate
emekçi	laborer
doksan	ninety
mühendisler	engineers
çöplük	dump
eğlenceli	fun
kurmak	establish
değirmencilik	milling
sansasyonel	sensational
yetki	authority
boğma	choke
dokuzuncu	ninth
önce	ago
tespitler	determinations
yaymak	spread
fahişeler	prostitutes
resimli	illustrated
sarkaç	pendulum
brifing	briefing
arzuları	desires
tutarlılık	consistency
seksi	sexy
konservatuvar	conservatory
çevik	agile
maymun	monkey
tanımlarken	defining
oksidatif	oxidative
başarmak	achieve
bunlar	these
yürütülebilir	executable
deneyimsel	experiential
ürpertici	creepy
taraklar	combs
romalılar	romans
yaptırım	sanction
efendimiz	sire
anonim	anonymous
herbisitler	herbicides
tımar	grooming
disiplin	discipline
yaşayabilirlik	viability
iyonik	ionic
tepeli	crested
vida	screw
sentetik	synthetic
iktidarsızlık	impotence
karikatür	cartoon
metadon	methadone
cömert	generous
öğrenme	learning
anemi	anemia
sebat	persistence
kanatlar	wings
arayan	caller
kazlar	geese
ihtiyaçlar	needs
fidye	ransom
genelleme	generalization
ortaçağ	medieval
simülasyonlar	simulations
araştırmacılar	researchers
mikrobiyoloji	microbiology
arabulucular	mediators
uzaysal	spatial
fotoğraflar	photos
kolombiya	colombia
sinüs	sinus
derleme	compilation
erişilen	accessed
akvaryum	aquarium
mavi	blue
güzel	pretty
reçineler	resins
sezmek	intuit
kavşaklar	intersections
tipi	type
almanca	german
özenli	attentive
tarama	scanning
alınan	received
marki	marquis
guruları	gurus
hırka	cardigan
pay	share
başlangıç	start
rock'çı	rocker
oymalar	carvings
açıklayıcısı	descriptor
dipnot	footnote
mühlet	respite
iyileşmek	heal
teknisyenleri	technicians
patronlar	bosses
aşağı	down
konserve	preserves
atlıkarınca	carousel
öf	ugh
yüzde	cent
hayalet	ghost
eğitmen	instructor
hurda	scrap
çıkışlar	downs
gündem	agenda
frenleyici	restraining
gruplama	grouping
cüzdanlar	wallets
yalıtılmış	isolated
katma	added
endokrinoloji	endocrinology
kullanılmamış	unused
belirtilmemiş	unspecified
tanımlamak	describe
asetat	acetate
diyaliz	dialysis
led	leds
askeri	military
nispeten	comparatively
kürtaj	abortion
bukle	curl
yazdı	wrote
transformatörler	transformers
koza	cocoon
savunuyor	argues
bilardo	billiards
kitapçı	bookstore
şaraphane	winery
teletıp	telemedicine
ırklararası	interracial
kontrol	control
lenfoma	lymphoma
keçe	felt
prosedür	procedure
bağımlı	dependent
sınırsız	unlimited
dokunulmamış	untouched
ekspres	express
halılar	carpets
eğrileri	curves
kilitsiz	unlocked
tornacı	turner
gladyatör	gladiator
tavizler	concessions
solenoit	solenoid
kutu	box
kiloluk	pound
uygulamaları	applications
eksantrik	eccentric
yasakları	bans
övünme	boast
şelaleler	waterfalls
bikiniler	bikinis
meyve	fruit
kütüphaneciler	librarians
kataloglama	cataloging
kompres	compress
açılımları	expansions
yerçekimi	gravity
materyal	material
motorlar	engines
torna	lathe
klapa	lapel
detektör	detector
tam	exact
evsahibi	host
popülerlik	popularity
fotonlar	photons
dokuma	weaving
ölümsüzlük	immortality
rapor	report
progesteron	progesterone
sempati	sympathy
bakım	maintenance
şekillendirme	forming
tepsi	tray
salata	salad
çapalar	anchors
kaligrafi	calligraphy
aralıklı	intermittent
bükme	bending
anlatılmamış	untold
arızaları	failures
yetiştiricilerinin	planters
tekne	boat
grafiği	chart
ambarlama	warehousing
devriye	patrol
hukuk	law
torpido	torpedo
yokluk	absence
lisansları	licenses
paranoya	paranoia
remixler	remixes
yürüdü	walked
ciddiyet	seriousness
florür	fluoride
aşmak	exceed
alenen	publicly
bekarlığa	bachelorette
sinaptik	synaptic
gelecek	future
köşk	pavilion
bağımsızlık	independence
kakao	cocoa
proaktif	proactive
sedir	cedar
bütünleşme	integration
öfkeli	furious
tehditler	threats
inorganik	inorganic
disiplinler	disciplines
sanıklar	defendants
anayasa	constitution
satır	row
yazarlar	writers
sıkıştırma	compression
toplamak	collect
sınırlama	limitation
alkalik	alkaline
koalisyonlar	coalitions
püskürtme	spraying
kaymak	slide
kasnak	pulley
letonya	latvia
birimsel	unitary
başlangıçları	debuts
votka	vodka
solmuş	faded
karlılık	profitability
stilleri	styles
önemli	important
paketler	packets
simpleks	simplex
krallar	kings
sokuldu	nestled
gruplar	groups
iltifat	compliment
kontes	countess
abaküs	abacus
on	ten
avı	hunt
ilk	first
naziler	nazis
navlun	freight
yatlar	yachts
yaratır	creates
yakıtlar	fuels
hırvatistan	croatia
paylaşım	sharing
proteomiks	proteomics
ekleme	adding
yayınlamaktadır	publishes
gelgit	tide
dergiler	magazines
optimizasyon	optimization
olimpiyatlar	olympics
örgütlü	organized
anomaliler	anomalies
çekişme	contention
italyanlar	italians
bütünsel	holistic
pastoral	idyllic
hayranlık	admiration
aktüatörler	actuators
damlatma	dropping
onbaşı	corporal
ifadeleri	statements
şarj	charge
çatlamış	cracked
balkonlar	balconies
kullanıcılar	users
avatarlar	avatars
hırslı	ambitious
çarpılır	multiplied
çatlaklar	cracks
azgınca	furiously
yabankedileri	wildcats
bulvar	boulevard
kızamık	measles
yaptım	did
istekliler	bidders
izafiyet	relativity
detay	detail
siklon	cyclone
kerata	rascal
belirir	appears
jant	rim
makaraları	reels
koşer	kosher
komando	commando
düzlemsel	planar
boynuzları	horns
bel	waist
zonlu	zoned
melanom	melanoma
vasat	mediocre
haritacılık	cartography
altmışlar	sixties
fildişi	ivory
kazılmış	dug
besleme	feed
memnuniyetsizlik	dissatisfaction
düzenle	edit
ziyaretçi	visitor
psikiyatristler	psychiatrists
azaltmak	reduce
pis	filthy
kuklalar	puppets
yaramazlık	mischief
isilik	rash
mikrodalga	microwave
pozitif	positive
çamur	mud
sazanlama	spoof
kaçış	escape
brüt	gross
lonca	guild
seçenekleri	options
orak	sickle
terk	abandonment
nörobilim	neuroscience
yorulmadan	tirelessly
iş	work
onaylı	approved
gözlemsel	observational
amplifikatör	amplifier
sent	cent
tilki	fox
damak	palate
durduruldu	stopped
tanım	definition
kiralama	hire
ikizler	twins
koşucu	runner
önlemek	avoid
düşünmek	consider
demokrasiler	democracies
koah	copd
yağlama	lubrication
işbirlikçiler	collaborators
kapasite	capacity
eko	echo
imalı	suggestive
tebrik	greeting
ben	i
aniden	suddenly
doku	tissue
hızlar	speeds
organizatörler	organizers
taslak	draft
bazal	basal
romanya	romania
devriyeler	patrols
sürgünler	shoots
vakitlilik	timeliness
n'inci	nth
denetçi	auditor
rezonans	resonance
komik	funny
linotip	linotype
kamarot	steward
nitrik	nitric
ofis	office
asgari	minimum
burjuva	bourgeois
sübvansiyon	subsidy
rakım	altitude
engelli	disabled
lcd'ler	lcds
çözme	solving
ametist	amethyst
konveyör	conveyor
sarar	wraps
sanayi	industry
şapka	hat
papatyalar	daisies
radikal	radical
ksenon	xenon
ayarlamaları	adjustments
belirgin	evident
mükemmellik	excellence
oransız	disproportionate
sallamak	shake
nimetler	blessings
diyagram	diagram
subay	officer
akarları	mites
küçük	small
termoplastik	thermoplastic
dışarı	out
kil	clay
brülör	burner
sonsuzluk	infinity
için	for
zeka	intelligence
homoseksüel	homosexual
sendikalar	unions
dilimlenmiş	sliced
lomber	lumbar
nasıl	how
uzuvlar	limbs
son	last
sırtları	backs
harmanlanmış	blended
gerilla	guerrilla
tahsis	allocation
geçmek	pass
şahin	hawk
adaylar	candidates
yemekler	meals
havaalanları	airports
düzeltilmiş	corrected
hünerli	ingenious
zencefil	ginger
dramalar	dramas
ihtilaf	dispute
girişimler	initiatives
ustabaşı	foreman
plastik	plastic
mikronezya	micronesia
kahve	coffee
seferberlik	mobilization
şekiller	shapes
cinsellik	sexuality
maksatlı	purposeful
acımasızlık	cruelty
şeker	sugar
nijerya	nigeria
hidroelektrik	hydroelectric
üslup	wording
arabulucu	mediator
böcek	insect
karyolaları	cots
arıtma	purification
tarafsız	unbiased
dolgu	filling
brokoli	broccoli
okutmanlar	lecturers
zamları	hikes
yaprak	leaf
tamponlu	buffered
tipografik	typographical
pahalı	expensive
budama	pruning
görünürlük	visibility
ekstraktör	extractor
vahiy	revelation
lanetli	damned
bilgelik	wisdom
reklamverenler	advertisers
cerrahlar	surgeons
rezalet	disgrace
aktivite	activity
kazanç	winnings
göstergeler	indicators
şema	schema
konveksiyon	convection
sayımları	counts
polipropilen	polypropylene
melodi	melody
klonlar	clones
çoğunluk	majority
fırınları	furnaces
ıskarta	discard
düzeltme	correction
büyüdü	grew
yazışma	correspondence
merdivenler	stairs
seribaşı	seeded
şayak	serge
jimnastik	gymnastics
endüstrileşmiş	industrialized
bütçe	budget
tüfek	rifle
tanzanya	tanzania
zorluk	difficulty
labirent	labyrinth
gömülü	buried
irade	will
anıtsal	monumental
oldukça	quite
şablon	template
heyecanlı	excited
cüce	dwarf
fahişe	whore
nitel	qualitative
haber	notice
karayolları	highways
steno	shorthand
sistemik	systemic
asya	asia
şaşırtıcı	amazing
gönderimler	submissions
deneme	trial
lando	landau
dayanıklı	resistant
akım	current
sadeleştirme	simplification
ayartma	temptation
fren	brake
scsı	scsi
orgazm	orgasm
meditasyonlar	meditations
selüloz	cellulose
lavabolar	sinks
organizasyon	organization
osteoartrit	osteoarthritis
bahamalar	bahamas
tökezleyerek	stumbling
belirli	certain
pompa	pump
pazarlanabilir	marketable
yineleyici	iterator
büyükelçi	ambassador
yarış	race
devrimler	revolutions
sınıflandırmalar	classifications
izlandaca	icelandic
fuarlar	fairs
mim	mime
kalır	stays
frenleme	braking
soydaş	kin
kontrol	check
basılabilir	printable
şoklar	shocks
mahkumiyet	conviction
çatılar	roofs
bakire	virgin
pasif	passive
havza	basin
motive	motivated
zürafa	giraffe
detoks	detox
spekülatif	speculative
kistik	cystic
faşist	fascist
oluk	groove
çamurluk	fender
çinko	zinc
aşılama	vaccination
veritabanı	database
muhasebeci	accountant
jeoloji	geology
müzikal	musical
yonga	chip
kırpma	clipping
dövülerek	pounded
çivit	indigo
başkent	capital
sürücüler	drivers
stres	stress
mücadele	struggle
karbonat	carbonate
genelleştirilmiş	generalized
terbiye	dressage
metinsel	textual
kimya	chemistry
pasaport	passport
eleman	element
kontrolü	control
incik	shank
yükseltmeleri	upgrades
etkilenmemiş	unaffected
yaşlar	ages
ananas	pineapple
yorumlamak	interpret
seçimler	elections
antivirüs	antivirus
doğru	true
çarpışma	collision
unutulmaz	unforgettable
şifrelenmiş	encrypted
kenarları	edges
sistemler	systems
e-postalar	emails
büyük	huge
görev	task
hortumlar	hoses
yol	path
tozlar	powders
katalitik	catalytic
amplifiye	amplified
raketbol	racquetball
tepkili	reactive
müslüman	muslim
kudüs	jerusalem
onkogen	oncogene
kapri	capri
değerlemeler	valuations
salgın	epidemic
gerek	need
tanrılar	gods
kanunsuz	unlawful
tümsekleri	bumps
kombi	combi
motosikletler	motorcycles
hükümetler	governments
fenotip	phenotype
tişörtleri	tshirts
yakında	soon
şüpheler	doubts
biçim	format
karıştırıcılar	mixers
parametrik	parametric
tomurcuklanan	budding
çağdaş	modern
planı	plan
ödül	prize
oksit	oxide
laboratuarları	labs
puro	cigar
orijinal	original
şiirsel	poetic
sorguları	queries
kural	rule
imparatorluk	empire
prototipler	prototypes
boksörler	boxers
inhibe	inhibited
tekerlek	wheel
beri	since
tıkmak	cram
jeofizik	geophysics
itaat	obedience
kaygı	anxiety
beytüllahim	bethlehem
temsil	representation
terapiler	therapies
şurup	syrup
psikologlar	psychologists
alacaklılar	creditors
samimiyet	sincerity
ürünler	products
gel	come
apoptoz	apoptosis
çiçek	flower
avlu	courtyard
düzenbaz	rogue
canlanma	revival
sahte	fake
fırıldak	windmill
karaçi	karachi
farklılaşmış	differentiated
yorumlar	comments
manipüle	manipulated
sahiplik	ownership
hesaplanmış	calculated
polen	pollen
özelleştirmek	customize
transistörler	transistors
erdem	virtue
safran	saffron
misafirperverlik	hospitality
denemeler	trials
kasa	safe
önermek	suggest
akran	peer
geçiştirmek	fudge
ekg	ecg
programlanabilir	programmable
tersledi	snapped
büyükanne	grandmother
konsantre	concentrated
yığınları	heaps
tespih	rosary
dağıtım	distribution
bekletilen	held
verici	transmitter
ingilizce	english
kiremitli	tiled
aralık	december
devirmek	overthrow
yoldaşlar	comrades
önce	before
ceo'lar	ceos
dildolar	dildos
himalaya	himalayan
stajlar	internships
inç	inch
nöbetler	seizures
fragmanları	fragments
sekmeler	tabs
sahil	coast
pencere	window
mağma	magma
türev	derivative
kromatografi	chromatography
konjonktürel	cyclical
hayati	vital
kurucular	founders
doz	dose
yararlananlar	beneficiaries
ses	sound
doğal	natural
çerçeveli	framed
krank	crank
mükemmel	excellent
refleks	reflex
patladı	exploded
manifoldlar	manifolds
kulaklık	headphone
amplifikatörler	amplifiers
kitap	book
öpücükler	kisses
sele	saddle
eşleştirme	pairing
sohbet	chat
ırkçı	racist
çelişki	contradiction
hibe	grant
lastikler	tires
marsilya	marseille
çiçekçiler	florists
biyopsi	biopsy
amerikan	american
kayakçı	skier
kısaltmak	shorten
cila	polish
çatlama	cracking
tekrar	repeat
prova	rehearsal
srcdirın	srcdir
jübile	jubilee
tavan	ceiling
arz	supply
rahiplik	priesthood
mahkumlar	prisoners
yanal	lateral
taksi	taxi
galvanize	galvanized
viyola	viola
potansiyel	potential
özledim	miss
müfredat	curriculum
sayaç	counter
gürleyen	booming
vatanseverlik	patriotism
enderlik	rarity
sıcaklıklar	temperatures
milyonlarca	millions
organ	organ
ılımlılık	moderation
sarılmak	hug
gizlilik	privacy
mahalleler	neighborhoods
gyo'lar	reits
delegeler	delegates
alan	field
aşıldı	exceeded
tuzakları	traps
ayin	ritual
tazelenmiş	refreshed
şerif	sheriff
testere	saw
dolandırıcılık	fraud
isa	jesus
telefoto	telephoto
tanrıça	goddess
komisyonculuk	brokerage
köklü	rooted
tutumlu	frugal
fırtınalar	storms
armutlar	pears
formül	formula
mümkün	possible
giyinik	clothed
babil	babylon
eğildi	leaned
ilçe	district
muhakeme	reasoning
tırmanış	climb
sorgu	query
şikayetler	complaints
kökleri	roots
becerileri	skills
glikoz	glucose
beyazlar	whites
kapaklar	caps
hakikat	truth
hatalar	mistakes
dehidrojenaz	dehydrogenase
belçika	belgium
tüketici	consumer
dinlenmiş	rested
gezegenler	planets
sorunlar	problems
özgürlük	freedom
belgeleme	certification
telifli	copyrighted
sakınca	drawback
işaretlenmiş	marked
darbelere	knocks
meteorolojik	meteorological
işaretleyici	marker
amatör	amateur
yedeklemeler	backups
şişeler	bottles
tasavvufi	mystical
parlamento	parliament
podcast	podcasts
tütsü	incense
fiyatları	prices
morfolojik	morphological
kökenleri	origins
kaşıntı	itching
haftalar	weeks
ışınlar	rays
polinomları	polynomials
alternatör	alternator
artrit	arthritis
avusturya	austria
musevilik	judaism
ulaşır	reaches
akrepler	scorpions
yapışmak	cling
dahası	moreover
yıldız	star
prospektüs	prospectus
keyfi	arbitrary
varlık	presence
yalıtmak	isolate
halhal	bangle
teşrih	dissection
yehova	jehovah
zararlı	detrimental
çeşitlendirme	diversification
çhandigarh	chandigarh
satmak	sell
şaplak	smack
yeşil	green
spektroskopisi	spectroscopy
körfez	gulf
özetleme	summarizing
okyanuslar	oceans
karnaval	carnival
kene	tick
tohumlar	seeds
sarılmalar	hugs
mesih	messiah
gaspçı	grabber
esintili	breezy
eşit	equal
atık	waste
referans	reference
kıpkırmızı	crimson
piyanist	pianist
codec'i	codec
lokomotif	locomotive
antikalar	antiques
uğrak	haunt
kültürel	cultural
estiren	spawned
kuş	bird
geleneksel	traditional
kayış	strap
haçlı	crusader
iskenderiye	alexandria
aşı	vaccine
protokol	protocol
temyiz	appeal
dilekçe	petition
müşteri	customer
sevinçleri	joys
ekson	exon
kartallar	eagles
idolleri	idols
vitrinleri	showcases
görenek	custom
oftalmoloji	ophthalmology
jakar	jacquard
avizeler	chandeliers
çile	suffering
tasfiye	liquidation
öğrenci	student
parmaklıklı	barred
sahnelenen	staged
editörler	editors
paradoks	paradox
yaralı	wounded
kleopatra	cleopatra
öklit	euclid
değil	not
antibiyotik	antibiotic
parti	party
kitapçık	booklet
tapınaklar	temples
emekleme	crawling
lezbolar	lesbos
hançer	dagger
bölümleme	partitioning
küçük	little
güneşsiz	sunless
toplayıcıları	collectors
dayakla	inflicted
istisnalar	exceptions
paket	package
direnerek	resisting
kışla	barracks
kastor	castor
provoke	provoked
krater	crater
inciller	gospels
istasyonlar	stations
kanguru	kangaroo
fırıncılar	bakers
dublajlı	dubbed
projeksiyonlar	projections
üretilmiş	produced
cuma	friday
laboratuarlar	laboratories
sopa	stick
susam	sesame
renk	color
bizon	bison
alır	gets
ceviz	walnut
şekerleme	confectionery
kokteyl	cocktail
prenses	princess
kanberra	canberra
cevaplanmamış	unanswered
şeyh	sheikh
dönüş	return
başlattı	launched
saçmalık	nonsense
bakanlık	ministry
delikler	holes
kilise	church
monoton	monotone
pigmentler	pigments
boyalar	paints
gramatik	grammatical
katmerli	laminated
elektrik	electric
bastırma	suppression
afiş	banner
kabartmak	fluff
ölçülü	measured
kışlar	winters
devleri	giants
hava	air
simir	smear
karakterler	characters
veronika	veronica
gazlı	gaseous
vasilik	guardianship
çoğul	plural
gelinler	brides
basılı	printed
etkisiz	ineffective
biyodizel	biodiesel
mesire	promenade
revize	revised
üniformalı	uniformed
sessiz	quiet
raporlama	reporting
klasikler	classics
futbol	football
kuyruklu	tailed
miktarlar	amounts
yükselir	rises
ortaklar	partners
teşekkürler	thanks
ragbi	rugby
koro	choir
kontaklar	contacts
yazarak	typing
sağlamlaştırma	consolidation
tabut	coffin
arşivlenen	archived
gül	rose
aksiyom	axiom
takıntı	obsession
kafkas	caucasian
uygulama	application
vakumlar	vacuums
dizel	diesel
bantlı	banded
mimik	gestures
yüzme	swimming
esasen	substantially
saat	clock
kraker	cracker
karıştırma	mixing
dekoratörler	decorators
horoz	cock
ithaf	dedication
kemerleri	belts
dakika	minute
prensler	princes
kasırgalar	hurricanes
kıvrımlar	folds
suriye	syria
golfçü	golfer
let	let
rota	route
emniyete	secured
modernizasyon	modernization
anormal	abnormal
kolonya	cologne
gözdağı	intimidation
çatallar	forks
fahrenhayt	fahrenheit
kamp	camp
duruş	stance
çizme	boot
çalılık	bushes
yapı	structure
devedikeni	thistle
içeren	contain
majör	major
apartman	apartment
ayrımcı	discriminatory
almanlar	germans
kayıp	lost
mürettebat	crew
karavanlar	caravans
clarinsve	clarins
sürprizler	surprises
lirik	lyric
otomatik	automatic
düğümleri	nodes
ağ	network
sınıf	class
orijinalleri	originals
far	headlight
boylam	longitude
segmentler	segments
boyutlu	dimensional
sicim	string
asansör	lift
revizyon	revision
pediatrik	pediatric
hücre	cell
cennet	paradise
inuyash	inuyasha
kuantum	quantum
haksız	unfair
dullar	widows
akik	agate
sözlü	verbal
yün	wool
sarı	yellow
şampiyona	championships
kesme	cutting
sen	you
püskürme	eruption
melezleme	hybridization
hizalı	aligned
çılgın	crazy
tekrar	again
yanlışlıklar	inaccuracies
penguenler	penguins
satırlar	rows
yarıştı	competed
turkuaz	turquoise
kahramanlar	heroes
imitasyon	imitation
tam	full
minder	cushion
niyagara	niagara
hızlı	quick
bu	those
emniyet	safety
majeste	majesty
madagaskar	madagascar
akademi	academy
cetveller	rulers
kucakladı	embraced
kuzular	lambs
eleştirmenler	critics
koruyucular	savers
şömine	fireplace
silmek	delete
vajinal	vaginal
pasajlar	passages
araştırılmış	researched
fareler	mice
memnuniyet	satisfaction
liberya	liberia
yelpaze	fan
abonelikleri	subscriptions
deneyimsiz	inexperienced
nüanslı	nuanced
donörler	donors
yükleniyor	loading
balıklar	fishes
fikir	idea
endeksli	indexed
indeksleme	indexing
lenfositler	lymphocytes
trenler	trains
çiçekçi	florist
himaye	auspices
aracı	tool
rakipler	opponents
protestan	protestant
suaygırı	hippo
şakacı	playful
malzemeler	materials
köpekbalıkları	sharks
artistik	artistic
el	hand
senkronizasyon	synchronization
genişletmek	expand
elma	apple
galeriler	galleries
sermayelendirme	capitalization
kronoloji	chronology
görünümler	views
birleştirme	combining
bavul	suitcase
kefillik	sponsorship
tutuşturmak	ignite
reaktörler	reactors
tutukluların	detainees
ağırbaşlı	dignified
ayaklar	feet
yolları	ways
özlemleri	aspirations
kampanyalar	campaigns
maksi	maxi
dolaşan	circulating
sormak	ask
çözücü	solvent
matik	matic
eter	ether
bağlanıyor	connecting
elektrotlar	electrodes
akustik	acoustic
mühürleme	sealing
çeşniler	condiments
devekuşu	ostrich
göstermektedir	indicate
jartiyer	garter
kararname	decree
performans	performance
atıştırmalıklar	snacks
gerçekleştirir	performs
kiralar	rents
kazıcı	digger
duyar	hears
çiftler	doubles
kitaplık	bookshelf
gülümseyen	smiling
limuzin	limousine
şarap	wine
gitarist	guitarist
cıvata	bolt
turist	tourist
pansuman	dressing
bilgisayarlar	computers
kruvazör	cruiser
portakal	orange
mobilyalı	furnished
uydular	satellites
eczane	pharmacy
nasıra	nazareth
dikkatli	careful
flanş	flange
toptan	wholesale
barbekü	barbecue
doğruluk	accuracy
deneyler	experiments
refinansman	refinancing
yığın	stack
toplanmış	collected
bu	this
diyafram	diaphragm
bu	these
kuzgunlar	ravens
yapma	making
meteoroloji	meteorology
gizem	mystery
başka	else
koşar	runs
etekler	skirts
proteinler	proteins
hokey	hockey
köprü	bridge
metabolitleri	metabolites
gazze	gaza
opaklık	opacity
gelişme	development
çek	czech
delüks	deluxe
sscb'nin	ussr
artışlar	increases
gezi	trip
erdemler	virtues
suşlar	strains
eğilimler	trends
sakız	gum
ultrasonik	ultrasonic
serbestleşme	liberalization
üreticileri	producers
sekti	bounced
yeremya	jeremiah
arjantinli	argentine
kolej	college
metil	methyl
ribozomal	ribosomal
uçtu	flew
monografi	monograph
kalabalık	crowded
tümörler	tumors
antioksidanlar	antioxidants
deneme	experiment
şeritler	strips
yanılsama	illusion
çizmek	draw
onkoloji	oncology
gürcü	georgian
anlam	meaning
zift	pitch
istiyorum	want
federe	federated
temsil	represent
taşeronlar	subcontractors
diyagramlar	diagrams
kazma	digging
fantom	phantom
sürüklenen	drifting
reseptörleri	receptors
balya	bale
aktör	actor
panik	panic
temizlenir	cleared
değişim	change
tipik	typical
damızlık	stud
servlet	servlets
sağlar	provides
boğulmuş	overwhelmed
buzul	glacier
kodeks	codex
muazzam	enormous
tasarlanmış	designed
sansürcü	censor
kurşunsuz	unleaded
yuvalama	nesting
kıdemli	senior
boncuklu	beaded
tekrarlanan	repeated
fişekleri	flares
tescilleri	registrations
adlandırma	naming
akrobat	acrobat
rozetler	badges
kirleticiler	pollutants
şah	shah
kancalar	hooks
sızıntı	leakage
aksesuar	accessory
borçlu	debtor
haberciler	messengers
paralel	parallel
midilli	pony
haraç	tribute
zayıflıklar	weaknesses
çok	much
gerçeklik	reality
ekonomiler	economies
ekosistem	ecosystem
kaliforniya	california
veterinerler	vets
eğrilik	curvature
tıkıştıran	tucker
endonezya	indonesia
uzay	space
yönlendiriciler	routers
hormonlar	hormones
ırkçılık	racism
ölümsüz	immortal
hızlı	fast
üzüntü	sadness
yöneteceksin	shalt
romatoloji	rheumatology
hafifletici	palliative
motivasyonları	motivations
koku	smell
kardeş	sister
uyluk	thigh
kemikler	bones
toplum	society
geliştirir	improves
saatler	watches
negatif	negative
adliye	courthouse
garson	waiter
tepe	hill
etf	etfs
imtiyazlar	liberties
kâbus	nightmare
mezotelyoma	mesothelioma
lobiciler	lobbyists
akçaağaç	maple
bilişimsel	computational
morfin	morphine
egzama	eczema
besleyiciler	feeders
eğitimciler	educators
muhafazakarlar	conservatives
puan	point
övgü	praise
yaşandığı	experiencing
makbuzlar	receipts
silâhsız	unarmed
saygıdeğer	venerable
anlayış	understanding
direnmek	resist
istikrar	stability
teselli	consolation
neden	why
karides	shrimp
ders	course
zırhlı	armored
ücretli	paid
sağlayıcılar	providers
danışmanları	consultants
sersemlemiş	dizzy
atmak	throw
kibir	arrogance
yolmak	pluck
kapsamları	scopes
doğum	birth
boole	boolean
indirme	lowering
odunsu	woody
çevreler	circles
nöroloji	neurology
kendiliğinden	spontaneously
kutlamak	celebrate
hollanda	netherlands
kıskançlık	jealousy
konuşulmuş	spoken
radyal	radial
litre	liter
brisbanetimes	smh
taylenol	tylenol
uyuyor	sleeping
sessizlik	silence
fenomen	phenomenon
çaylar	teas
orantılı	proportional
cezayir	algeria
ölçekleme	scaling
ihmal	neglect
yansımalar	reflections
disleksi	dyslexia
doğrulayin	verify
tırmandı	climbed
tutumlar	attitudes
amerikalılar	americans
esnek	flexible
planlamacı	planner
puding	pudding
füzyon	fusion
zâviye	lodges
yapılan	made
elektromanyetik	electromagnetic
kanıtlıyor	proves
hidroloji	hydrology
kelt	celtic
perakende	retail
teksaslı	texan
seçmenler	electorate
moleküller	molecules
havzaları	basins
tutarsızlık	inconsistency
inek	cow
açık	clear
ayı	bear
atasözleri	proverbs
düşünce	thought
komutlar	commands
ışınlama	irradiation
klitoris	clitoris
kâlbi	heartland
bebek	baby
lezbiyenler	lesbians
şerit	strip
portre	portrait
torunlar	grandchildren
yükseltmek	raise
dirsek	elbow
tapınak	temple
kankurutan	mandrake
kaseler	bowls
öksürük	cough
hane	digit
anma	mention
biyokütle	biomass
kombine	combined
sekiz	eight
dalma	plunge
yosun	moss
makedonyalı	macedonian
kehanetleri	prophecies
riskler	risks
saçlı	haired
cırt	velcro
aboneler	subscribers
eyersiz	bareback
ocak	january
ıspanak	spinach
alaşımlar	alloys
fethetmek	conquer
uzmanlık	expertise
sentetaz	synthetase
oyunu	game
hipnoz	hypnosis
senato	senate
girin	enter
dantel	lace
kanal	channel
genişleme	expansion
ünlü	famous
kütüphaneci	librarian
çekici	attractive
ladin	spruce
paskalya	easter
başlıksız	untitled
baraj	dam
iframe'ler	iframes
skuba	scuba
immünoloji	immunology
rapsodi	rhapsody
konsolos	consul
hoparlörler	speakers
yürüteç	walker
karşılaştırma	comparison
empati	empathy
hipertansiyon	hypertension
eksen	axis
eğlence	entertainment
açgözlü	greedy
tabur	battalion
zaten	already
doyma	saturation
hız	speed
ast	subordinate
maceraperest	adventurous
tema	theme
bozmak	disrupt
cips	chips
tuzlan	salts
rakam	figure
uyur	sleeps
paralimpik	paralympic
lake	lacquer
fırın	bakery
eksileri	cons
benimser	adopts
ranza	bunk
yetiştiricileri	growers
demografisi	demographics
harap	ruined
beslemek	feed
dondurucular	freezers
kılıç	sword
lastik	tire
taşma	overflow
bayesci	bayesian
kızılcık	cranberry
üreme	reproductive
saat	hour
nedime	bridesmaid
havuzlama	pooling
pazarlama	marketing
kataloglar	catalogs
erime	melting
akşam	evening
irfan	lore
zihinler	minds
vokal	vocal
vatandaşlık	citizenship
şekil	figure
aktüeryal	actuarial
maldivler	maldives
balistik	ballistic
maddeler	substances
listeleme	listing
zengince	richly
kediler	cats
mozambik	mozambique
obstrüktif	obstructive
granül	granular
ekim	october
işsiz	unemployed
poz	pose
anormallikler	abnormalities
tazelik	freshness
dallanma	branching
geçişler	transitions
mitingler	rallies
aralıklar	ranges
azerbeycan	azerbaijan
tesisler	facilities
hoş	pleasant
derinlik	depth
harikaları	wonders
beyhude	futile
kaldı	stayed
hatırlatan	reminding
tutum	attitude
ayakta	standing
teraslar	terraces
solan	fading
otomasyon	automation
yüzyıllık	centennial
konsol	console
ötesinde	beyond
görüşmeci	interviewer
kartları	cards
yapraklı	leafy
mezar	tomb
şeffaflık	transparency
broker	brokers
kondansatör	capacitor
lekeli	stained
antlaşmalar	treaties
büyük	large
ulus	nation
sansürlü	censored
parmaklama	fingering
ölçümler	measurements
oküler	ocular
dişler	teeth
peri	fairy
atlanır	skipped
sözlük	dictionary
izdiham	confluence
askılar	hangers
müritler	disciples
görünüşteki	seeming
kesici	cutter
halklar	peoples
envanter	inventory
yani	mean
şömineler	fireplaces
enjekte	injected
parçalar	parts
devralmalar	acquisitions
slovakya	slovakia
gösterilen	shown
programlanmış	programmed
koyarak	putting
sorumluluk	responsibility
yürümek	walk
kokuyor	smells
annuiteleri	annuities
bilir	knows
kozmoloji	cosmology
kemer	belt
genbankası	genbank
gösteriler	demonstrations
bu	that
seninki	yours
ötenazi	euthanasia
duvak	veil
gerisi	rest
profiller	profiles
takımyıldız	constellation
hatırlatmak	remind
yerleştirmek	locate
venöz	venous
yolcular	passengers
hazırlık	preparation
beşinci	fifth
immünoglobulin	immunoglobulin
casusluk	espionage
şık	stylish
masif	massive
portföy	portfolio
koru	grove
girişimcilik	entrepreneurship
motivasyonel	motivational
ataşeler	attaches
normalize	normalized
kehribar	amber
etiyopya	ethiopia
takı	jewelry
polimerler	polymers
soluk	pale
sütunlar	columns
anahtarlama	switching
mermi	bullet
güzelce	nicely
örgütsel	organizational
havuçlar	carrots
şemsiye	umbrella
gezileri	trips
kanserler	cancers
onsekiz	eighteen
kayıtsızlık	indifference
ışın	ray
işçi	worker
popüler	popular
lenfosit	lymphocyte
üstleri	tops
sürpriz	surprise
nem	moisture
kısmen	partially
kararlar	decisions
antagonistleri	antagonists
biokimya	biochemistry
amiral	admiral
efedrin	ephedrine
bahçıvan	gardener
örnekleme	sampling
üfleyici	blower
fısıldıyor	whispers
kesir	fraction
uyarlamak	adapt
titizlikle	meticulously
katedral	cathedral
teşrifleri	attends
borç	debt
sırlar	secrets
denilen	called
rehineler	hostages
kabuklar	shells
gürültülü	noisy
peroksit	peroxide
yönetir	manages
zayıf	weak
hormonsal	hormonal
kaymalar	shifts
lekeleme	staining
kozmetik	cosmetic
sebzeler	vegetables
yiyen	eater
canavarlar	monsters
uyanmalar	awakenings
yakınları	relatives
evsizlik	homelessness
sanitasyon	sanitation
patlamalar	explosions
davul	drum
atfedilen	attributed
insanlık	humanity
indirgen	reducing
mal	goods
ısdn	isdn
cumartesi	saturday
küçültmek	shrink
üçgen	triangle
hasır	wicker
metinler	texts
mahmuz	spur
büyükelçiler	ambassadors
zihniyet	mentality
tombul	chubby
eşlenen	mapped
singapur	singapore
depolar	stores
altyapı	infrastructure
bilim	science
solunum	respiratory
ugandalı	ugandan
kapı	door
kardiyovasküler	cardiovascular
okul	school
teklifçi	bidder
cezalar	penalties
mahçup	embarrassed
kazık	stake
mutluluk	happiness
amortisman	depreciation
kesinti	interruption
haritalar	maps
özgürlükler	freedoms
glüten	gluten
biracı	brewer
kereviz	celery
sızlanan	whining
silikon	silicon
toksik	toxic
doldurmak	populate
kavuşum	synod
kart	card
şerefe	cheers
ağızlık	nozzle
değerlendirmek	evaluate
sadaka	charity
rampa	ramp
sentezleyici	synthesizer
takipçi	follower
livecam'lere	livecams
sentez	synthesis
tehlikeleri	dangers
enerji	energy
kule	tower
kredi	credit
tente	awning
kask	helmet
süredurum	inertia
ateştopu	fireball
otomotiv	automotive
pirzola	chop
imparatoriçe	empress
kıdem	seniority
soygun	robbery
patenciler	skaters
afrodit	aphrodite
kroşe	crochet
balon	balloon
diyagonal	diagonal
başkanlık	presidential
bulutlu	cloudy
krişna	krishna
kabiliyet	capability
bakireler	virgins
yoğunlaşmak	concentrate
çekişmeli	contentious
polis	police
katastrofik	catastrophic
nöron	neuron
girift	intricate
giydiği	wore
katmandu	kathmandu
sigorta	insurance
masmavi	azure
içgüdüleri	instincts
bahşiş	tip
trilyon	trillion
gerçekleştirmek	realize
cıvataları	bolts
ahlâk	morality
randomize	randomized
plakalar	plates
ohm	ohms
canlı	live
stabilize	stabilizing
hemşireler	nurses
icat	invention
kalın	thick
teslimatlar	deliveries
daldırma	dip
aptal	stupid
merkez	center
güzellik	beauty
italya	italy
kirlilik	pollution
zevkler	pleasures
kalça	hip
neden	reason
yem	forage
ağlamak	cry
kısaca	briefly
yüklem	predicate
nektar	nectar
herkes	everyone
deneyimli	experienced
pedagojik	pedagogical
kaktüs	cactus
okkalı	whopping
türleri	types
tunus	tunisian
vaaz	sermon
cihazlar	devices
büsbütün	downright
forumlar	forums
ve	and
virjinya	virginia
şaft	shaft
adı	name
yanlamasına	laterally
binalar	buildings
at	horse
kasım	november
tüysüz	hairless
çelişmek	contradict
nişanlı	engaged
çöller	deserts
çünkü	because
alıcılar	buyers
göstericiler	demonstrators
kavak	poplar
astım	asthma
dövülmüş	beaten
isteksizce	reluctantly
kelebekler	butterflies
mıknatıs	magnet
döngüleri	cycles
zambaklar	lilies
yıldönümleri	anniversaries
cesurca	bravely
kuşaklararası	intergenerational
demlik	teapot
sahiller	beaches
kilometre	kilometer
adaletsizlik	injustice
mimari	architectural
osilatör	oscillator
kortikal	cortical
folik	folic
sınıflandırılmamış	unclassified
bilimler	sciences
umutsuzca	desperately
tutturma	fastening
tutulan	held
tavsiye	advice
kafein	caffeine
shall	shall
moteller	motels
teröristler	terrorists
omurga	spine
klasör	folder
akdeniz	mediterranean
bizim	our
karşılaşılan	encountered
kanamak	bleed
idari	administrative
psikolog	psychologist
narkotik	narcotic
klasik	classical
düşünme	thinking
boşanmış	divorced
sürüler	shoals
yalnız	alone
kanama	bleeding
saçılma	scattering
cesaret	courage
sanat	art
sınıflandırma	classification
güçlendirme	strengthening
japonya	japan
fısıltı	whisper
alimler	scholars
çabalayan	humping
akılcı	rational
düşman	enemy
lübnan	lebanon
yaramaz	naughty
kimin	whose
fırça	brush
gerekçeli	reasoned
halka	ring
dul	widow
kongre	congress
prognoz	prognosis
osteoporoz	osteoporosis
gençlik	youth
buketler	bouquets
maskeleme	masking
cümleler	sentences
detaylı	detailed
bitli	lousy
oldu	been
direnç	resistance
içindekiler	contents
akordeon	accordion
makineler	machines
sürüngen	reptile
cümle	sentence
japonca	japanese
pencap	punjab
kalamar	squid
moğolca	mongolian
kategorik	categorical
röntgenci	voyeur
hakemli	refereed
ilerlemek	advance
maaşları	salaries
büyüyen	growing
ayrılmak	leave
smokini	tux
aygır	stallion
porsuk	badger
dikine	vertically
biyografi	biography
dart	darts
bahçeleri	gardens
akasya	acacia
kimse	nobody
unutmak	forget
yuvarlatma	rounding
düzgünce	smoothly
kategoriler	categories
semitizm	semitism
cebir	algebra
yerleşir	settles
yenilebilir	edible
umman	oman
değişken	variable
anlaşma	deal
kodein	codeine
pire	flea
neoplazmlar	neoplasms
yağışlı	rainy
devasa	colossal
besteci	composer
iran	iranian
sevinç	joy
soğan	onion
elçilik	embassy
sekreterler	secretaries
fas	morocco
eklektik	eclectic
oturumları	sessions
genlik	amplitude
meraklıları	enthusiasts
hiciv	satire
mirasçılar	heirs
gevreği	flakes
seçmen	voter
geçmiş	past
reçeller	jams
sonek	suffix
hissedarlar	shareholders
saatlik	hourly
kesilme	cessation
donuyor	freezes
bürokratik	bureaucratic
kilitleme	locking
ultrastrüktür	ultrastructure
muhasebe	accounting
diplomasi	diplomacy
hristiyan	christian
yarışmalar	competitions
sıçrama	splash
arma	rigging
böcekli	buggy
melodik	melodic
doktrinler	doctrines
onurlu	honorable
görüldüğüne	sightings
yemin	oath
çello	cello
kupalar	mugs
eşyalar	things
öğretir	teaches
kesmek	cut
henüz	yet
avcı	hunter
kontrollü	controlled
viraj	bend
hedefler	targets
süsler	ornaments
mirasçı	heir
izledi	watched
invertör	inverter
adilce	justly
kürlenmiş	cured
karşı	to
illüzyonlar	illusions
sünni	sunni
göl	lake
balıkçılar	fishermen
piknik	picnic
trombon	trombone
mantıksal	logical
vulkan	vulcan
ayrıca	also
tekil	singular
giyer	wears
avustralasya	australasia
biyosfer	biosphere
kremsi	creamy
meşgul	busy
altbölüm	subsection
transkripsiyon	transcription
çatlak	crack
tablolar	tables
duyulmamış	unheard
soğuk	cold
ihmalkâr	negligent
kardinal	cardinal
endişeli	worried
memeliler	mammals
gala	premiere
şiraz	shiraz
içerideki	insider
madeni	metallic
vatandaş	citizen
taahhütler	commitments
sonrası	post
dizayn	design
ifşa	disclosure
sözcük	word
yıldızlar	stars
vuruş	strike
gösterdi	showed
uydurma	fitting
militanlar	militants
örnekler	examples
dinlenme	rest
ağıt	lament
tekme	kick
kırılgan	fragile
çiğneme	chewing
otantik	authentic
naylon	nylon
tanınabilir	recognizable
psikolojik	psychological
pas	rust
şapkalı	capped
şempanze	chimp
kükreyen	roaring
karbon	carbon
şifreleri	passwords
komünist	communist
yarıçap	radius
tartışmalar	discussions
selektör	selector
yamaçlar	slopes
hoşgörüsüzlük	intolerance
güzel	beautiful
komuta	command
karışıklık	confusion
hobiler	hobbies
danimarkalı	danish
rektal	rectal
şarkı	song
kabarcık	bubble
formaları	jerseys
pekiştiriyor	reinforces
kahvaltı	breakfast
peptid	peptide
adaptif	adaptive
teğet	tangent
flaman	flemish
sigortalamak	insure
uranyum	uranium
yunus	dolphin
kamera	camera
yunanistan	greece
enkaz	debris
bitiş	finish
larvalar	larvae
seviyelendirme	leveling
run	run
yetersiz	insufficient
kafeterya	cafeteria
astar	lining
şampanya	champagne
fizyoterapi	physiotherapy
bekçileri	keepers
ensest	incest
saygı	respect
skeçler	sketches
yüzeyler	surfaces
tokmak	knob
semboller	symbols
softbol	softball
gerçeküstü	surreal
emisyon	emission
tevazu	humility
bilek	wrist
endikasyonları	indications
iklimler	climates
şarbon	anthrax
flemenkçe	dutch
tanılama	diagnostics
teşhircilik	exhibitionism
sürücü	drive
projekte	projected
arginin	arginine
uyudu	slept
kontraseptifler	contraceptives
öğütücü	grinder
kiralanmış	rented
iyon	ion
önsöz	preamble
sürdürmek	maintain
fakir	poor
ikame	substitution
mevsimler	seasons
lansmanlar	launches
hamile	pregnant
baldırlar	thighs
şili	chile
bağırmak	shout
benzersiz	unique
kareler	squares
kalıplanmış	molded
acele	hurry
gizleme	hiding
enzimler	enzymes
kasap	butcher
belediyeler	municipalities
hizmet	serve
türetme	derivation
taş	stone
eliminasyon	elimination
varyansları	variances
güveç	casserole
enzimolojisi	enzymology
şart	condition
ebegümeci	hibiscus
boyacılar	painters
çekirdek	core
tuğla	brick
hissediyor	feels
napolyon	napoleon
tutkal	glue
avantajlı	advantageous
ayrı	separate
böğürtlen	blackberry
yüklenenler	uploads
ırklar	races
muzdârip	stricken
serçe	sparrow
başarısızca	unsuccessfully
urduca	urdu
felsefi	philosophical
satıcılar	sellers
uçmak	fly
sonucuna	concluded
fonksiyonlar	functions
görüşlü	sighted
ayrıntılar	details
kürklü	furry
yavaş	slow
atpaz	atpase
kimlikleri	ids
sakson	saxon
antropojenik	anthropogenic
arılar	bees
denklem	equation
karşılayan	meets
yansıma	reflection
bakkaliye	groceries
hobi	hobby
arter	artery
bekliyoruz	expect
uygun	proper
tek	single
inceltme	thinning
tirosin	tyrosine
filoları	fleets
meridyen	meridian
eşdeğerleri	equivalents
kiler	cellar
arşivci	archivist
gerektiğini	ought
bağ	bond
fizikçiler	physicists
uykuda	asleep
ikilik	duality
çayır	meadow
depresif	depressive
filipinler	philippines
eliptik	elliptical
alçıpan	drywall
yatırımlar	investments
adaptör	adapter
ışıklar	lights
dokular	textures
anlaşılabilir	understandable
kuyumcular	jewelers
uzantı	extension
kenarlı	edged
dün	yesterday
onur	honor
yüklemler	predicates
kaydırdı	slid
flaş	flash
kırdı	broke
çarpan	multiplier
basın	press
trajik	tragic
doldurun	fill
seksenler	eighties
atlamacı	jumper
anüs	anus
amorf	amorphous
çocuk	child
konstrüksiyonlar	constructions
kromozomlar	chromosomes
hiyerarşik	hierarchical
projektör	projector
bildirimleri	notifications
uzman	expert
mesajları	posts
terapistler	therapists
küçültücü	degrading
ayetler	verses
duyuru	announcement
istifçi	stacker
popo	butt
krallıklar	kingdoms
konuşma	talk
paspas	mop
kapasitans	capacitance
harcama	spending
eserleri	works
kararsız	unstable
codec	codecs
fazer	phaser
dışlamak	exclude
layık	worthy
tenis	tennis
epoksi	epoxy
bölgeler	regions
bisiklet	bike
bayındır	flourishing
dudaklar	lips
tozlu	dusty
otizm	autism
dinlemek	listen
kardiyoloji	cardiology
uygulama	practice
oyuncu	player
vay	wow
diye	he
koleksiyonları	collections
sıkıcı	boring
yüzlü	faced
yerel	local
iyimserlik	optimism
modları	modes
dokunulmazlık	immunity
korkuyor	afraid
sonik	sonic
sıcaklık	temperature
eleştirdi	criticized
slovenya	slovenia
artmış	increased
ekvador	ecuador
yakarma	invocation
moğolistan	mongolia
dağlar	mountains
bastırmak	suppress
karayip	caribbean
kartuş	cartridge
gazlar	gases
zaferler	victories
oto	auto
kopenhag	copenhagen
iddianame	indictment
mozaik	mosaic
oğlu	son
çorak	barren
vizon	mink
böğür	flank
perakendeciler	retailers
oğlan	boy
hatırlatır	recalls
fiyatlı	priced
bantları	bands
bilmek	know
kalsiyum	calcium
tekila	tequila
fincan	cup
psikiyatrist	psychiatrist
eksperleri	surveyors
olabilir	could
engerek	viper
bronzlaşma	tanning
olimpos	olympus
faul	foul
yenilenebilir	renewable
cdleri	cds
gündemler	agendas
firavun	pharaoh
fanatik	fanatic
gülmek	laugh
üniforma	uniform
yorumlanır	interpreted
damlama	drip
kurtlar	wolves
pati	paw
değişmekteydi	ranged
napoli	naples
siber	cyberspace
pimleri	pins
adaları	islands
homeopati	homeopathy
yönetilen	managed
başkentler	capitals
asla	never
ıas	ias
vurgu	emphasis
lezbo	lesbo
banço	banjo
konforları	comforts
pelerin	cloak
dumanlı	smoky
içerik	content
bloglar	blogs
menopoz	menopause
dövmeler	tattoos
travestileri	transvestites
plaj	beach
adım	step
iyice	thoroughly
kültürlü	cultured
farklı	differ
dokuz	nine
düşürmek	drop
çalı	bush
gezdi	toured
balo	prom
hanedan	dynasty
bileşik	compound
güven	confidence
geniş	broad
istatistik	statistics
titanyum	titanium
sezon	season
kırmızılar	reds
baskı	printing
oyalama	distraction
bağış	donation
morötesi	ultraviolet
parodi	parody
öngörü	foresight
şubat	february
girişimciler	entrepreneurs
sözdizimi	syntax
melek	angel
karıncalar	ants
haşlanmış	boiled
sıkıştırılmış	compressed
izotoplar	isotopes
gezinti	stroll
vinçler	cranes
ışık	light
kübalı	cuban
seyirci	spectator
değişmemiş	unchanged
kimyasal	chemical
mübarek	blessed
karantina	quarantine
korumalı	protected
elemek	eliminate
stratejik	strategic
eklentileri	plugins
beyan	statement
diyalog	dialogue
yıkım	demolition
alaaddin	aladdin
pusu	ambush
geçiş	transition
tüvit	tweed
öldürmek	kill
fonksiyonel	functional
antarktika	antarctica
açıklamak	explain
uyarılar	warnings
mitler	myths
pediatri	pediatrics
oranları	rates
esrarkeş	junkie
url'ler	urls
sağlıksız	unhealthy
kafkaslar	caucasus
vurmak	hit
anahtarlar	keys
traktör	tractor
galon	gallon
sürüklemek	drag
gsyh	gdp
mobilet	scooter
denizaşırı	overseas
vergi	tax
digimode	digimon
histoloji	histology
iltihap	inflammation
illüstratörler	illustrators
hesaplanıyor	calculating
rosto	roast
bej	beige
anlık	instant
radyolar	radios
ezilmiş	crushed
başpiskopos	archbishop
nekroz	necrosis
papa	pope
demografik	demographic
anketler	polls
yük	load
biyolog	biologist
aritmetik	arithmetic
glikol	glycol
bağsız	unbound
peygamberler	prophets
ördekler	ducks
derlemeler	compilations
göçmen	immigrant
böbrekler	kidneys
kırpıntı	clippings
yıkmak	destroy
salmak	unleash
şişman	fat
köşetaşı	cornerstone
kümülatif	cumulative
repertuar	repertoire
birleşmeler	mergers
yarımada	peninsula
sembolik	symbolic
keskin	sharp
katalizatör	catalyst
psiko	psycho
mimar	architect
yanaklar	cheeks
ordu	army
hendek	ditch
kolaylıklar	amenities
adli	judicial
ılıman	temperate
soğutucu	cooler
formatları	formats
emektar	veteran
mucit	inventor
otostopçu	hitchhiker
seviyeleri	levels
dolaştım	wandered
nehir	river
uyarlamalar	adaptations
fentermin	phentermine
pedallar	pedals
hapsolmuş	trapped
geyik	deer
kayıtsız	indifferent
füzeler	missiles
nitelikleri	qualities
yürütülen	conducted
demokrat	democrat
dönüşümler	transformations
tetik	trigger
bildirilmemiş	undeclared
isyancılar	rebels
heterojenliği	heterogeneity
siyah	black
yalan	lie
ilahiyat	theology
sıkıntılı	distressed
marangozluk	carpentry
araştırdı	explored
orkide	orchid
kapmak	grab
iğneleme	sarcasm
kampçılar	campers
şartlandırma	conditioning
maksvel	maxwell
normalde	normally
ısıtılmış	heated
sivil	civilian
gözaltı	custody
sallanan	rocking
caydırmak	deter
şehvetli	sensual
sabitlendi	pinned
kaza	accident
bulgaristan	bulgaria
keşiş	monk
ortak	partner
kaybolmamış	extant
balık	fish
prezervatif	condom
kokain	cocaine
empedans	impedance
dalgalanmalar	fluctuations
asimetrik	asymmetric
yarıları	halves
bağışık	immune
arnavutluk	albania
terazi	scales
activitiies	marriott
sırbistan	serbia
buğulama	steamed
bilet	ticket
emdi	sucked
kadmiyum	cadmium
avukatları	lawyers
intihar	suicide
macellan	magellan
radikaller	radicals
karbonhidrat	carbohydrate
katır	mule
kovaryans	covariance
koordinatlar	coordinates
kedi	cat
aralandı	parted
uygar	civilized
dövme	tattoo
mitokondrial	mitochondrial
merkezleri	centers
inanıyorum	believe
süreç	process
etler	meats
altyordamı	subroutine
musluklar	taps
hediyelikler	giftware
kaçırılan	kidnapped
testereler	saws
soğutma	cooling
nitrat	nitrate
öykünme	emulation
demirciler	smiths
karayolu	highway
demleme	infusion
teta	theta
parantez	brackets
kaçamaklar	getaways
kişiselleştirilmiş	personalized
parıltı	glare
telefon	telephone
muafiyet	exemption
davacı	plaintiff
tepeler	hills
rasgele	random
sırım	thong
karbonhidratlar	carbohydrates
bıçkıcı	sawyer
ev	house
avuç	handful
feminizasyon	feminization
parşömen	parchment
sarmaşık	ivy
dizler	knees
kopyalar	copies
kuvars	quartz
musluk	tap
koloni	colony
sabır	patience
çukur	pit
anti-enflamatuar	anti-inflammatory
jetleri	jets
filaman	filament
öğrenenler	learners
silendirler	casts
haçlılar	crusaders
yüzyıllar	centuries
sonuç	result
portekizce	portuguese
afedersiniz	sorry
tüketicilerin	consumers
genişletici	extender
ahbaplar	dudes
ergenler	adolescents
evli	married
ruanda	rwanda
çiy	dew
taylar	colts
mıknatıslar	magnets
barlar	bars
ispanya	spain
robotlar	robots
şüphecilik	skepticism
meze	appetizer
bağımsız	independent
traş	shaved
sarımsak	garlic
tapılası	adorable
parseller	parcels
sayım	census
zeytin	olive
sap	handle
sundurma	porch
koltuk	armchair
komünistler	communists
hristiyanlık	christianity
debriyaj	clutch
pişmiş	baked
muson	monsoon
teşekkür	thank
ayak	foot
yönlendirildi	redirected
tehlikeli	dangerous
mayınlar	mines
kiracılık	tenancy
hafta	week
tarihi	historical
duyuyorum	am
kayaklar	skis
demografi	demography
kollajen	collagen
teoriler	theories
getirmek	bring
ebeler	midwives
yaratıklar	creatures
eylemciler	activists
ihtiyatla	cautiously
terim	term
asimilasyon	assimilation
fizyoloji	physiology
ergonomik	ergonomic
doğurmak	breed
ihanet	betrayal
bir	an
sigaralar	cigarettes
simülasyon	simulation
yetmiş	seventy
havadar	airy
hariç	excluding
doğru	toward
önler	prevents
çim	grass
kiosklar	kiosks
erişilemez	inaccessible
kalvin	calvin
rotasyonel	rotational
psikiyatri	psychiatry
büst	bust
filo	fleet
kreş	nursery
zombiler	zombies
ret	denial
fermantasyon	fermentation
sertifika	certificate
aşk	love
kontrolör	controller
elimine	eliminated
siyanür	cyanide
numara	number
oluşturulan	created
enstitüleri	institutes
alıç	hawthorn
kaldırır	removes
panteon	pantheon
keçi	goat
manyetizma	magnetism
aşıklar	lovers
menteşeli	hinged
dekanlar	deans
kampanya	campaign
madde	substance
açıkça	clearly
denemek	try
vatan	homeland
gen	gene
ezici	overwhelming
reseptörü	receptor
metres	mistress
adaptasyon	adaptation
kabinleri	booths
hindistan	india
kürt	kurdish
imha	destruction
krom	chromium
pistonlar	pistons
yavaşça	slowly
savunucu	advocate
cehalet	ignorance
veranda	patio
ceket	jacket
rol	role
nitelendirir	qualifies
bohem	bohemian
büyük	big
gemiler	ships
iyot	iodine
titreşimler	vibrations
korkmuş	frightened
rüyalar	dreams
ince	thin
kiropraktik	chiropractic
selülit	cellulite
yansıtmak	reflect
bitti	done
diktatör	dictator
tantana	fanfare
halat	rope
aldığı	receives
çakmaktaşı	flint
haritalama	mapping
görüntüleme	visualization
metodoloji	methodology
olgun	mature
koridor	corridor
katlanarak	exponentially
rahatsızlık	discomfort
biyolojik	biological
handikap	handicap
katlanmış	folded
zilleri	ringers
mikrofon	microphone
benzer	similar
sokak	street
yasadışı	illegal
kanıtlamak	prove
girer	enters
faaliyetler	activities
steril	sterile
onsekizinci	eighteenth
çocuklar	children
tanıtım	promotion
sakar	clumsy
doç	assoc
terzilik	tailoring
biyoçeşitlilik	biodiversity
seyir	cruising
eroin	heroin
doktora	doctorate
septik	septic
çan	bell
çorap	socks
trans	trance
ölçeklenebilirlik	scalability
tabureler	stools
dağcılar	climbers
anakara	mainland
kalite	quality
anket	survey
bağlaç	conjunction
kanıt	evidence
imparator	emperor
sakince	calmly
otomatikleştirmek	automate
coğrafi	geographical
hayırsever	charitable
hisseleri	shares
ağaçkakan	woodpecker
çarpılması	multiplying
türbinler	turbines
bluz	blouse
hangi	which
şairler	poets
analizleri	analyses
pansiyon	hostel
uzantılar	extensions
heteroseksüel	heterosexual
çakmak	lighter
öngörme	forecasting
başlı	headed
etkinleştirmek	activate
borçlar	debts
bültenleri	releases
ortaklıklar	partnerships
katsayıları	coefficients
tavuskuşu	peacock
gerçek	fact
istifa	resignation
çorbalar	soups
tosbağa	tortoise
pekan	pecan
planör	glider
vadiler	valleys
sahip	owner
saraylar	palaces
biyomedikal	biomedical
ikilem	dilemma
tutuklamak	arrest
anırmak	bray
oryantasyon	orientation
patlamak	burst
kan	blood
dokunsal	tactile
yasallık	legality
radyoloji	radiological
beş	five
değerleme	valuation
puanlama	scoring
eşcinsellik	homosexuality
kombinasyon	combination
metodolojiler	methodologies
alüminyum	aluminum
hizipler	factions
çevre	environment
ayarlanabilir	adjustable
regexp'in	regexp
tanıma	recognition
biletler	tickets
bakanlar	ministers
afişler	posters
badem	almond
glutatyon	glutathione
slipleri	slips
dekan	dean
ayrıcalıkları	privileges
erkekler	men
periyodik	periodic
seçkinler	elite
uvertür	overture
ruslar	russians
burs	scholarship
veteriner	veterinary
kurgu	fiction
ittifaklar	alliances
yüklü	loaded
tüneller	tunnels
hastalık	disease
patlak	goggle
sürü	herd
göğüsler	boobs
bağıl	relative
anlaşmazlıklar	disputes
aromaterapi	aromatherapy
çobanlar	shepherds
memeli	mammal
haplar	pills
tereyağı	butter
huzur	serenity
burbon	bourbon
ittifak	alliance
dedi	said
güreşçi	wrestler
sigortalı	insured
saygılı	respectful
vali	governor
azınlıklar	minorities
paraşüt	parachute
hissedar	shareholder
okullar	schools
fethetti	conquered
inci	pearl
tuttu	kept
tökezledi	stumbled
karasal	terrestrial
niş	niche
zayıflama	weakening
yuvarlak	round
israilli	israeli
stüdyo	studio
düzenekleri	assemblies
fluoksetin	fluoxetine
sitoplazmik	cytoplasmic
kartuşlar	cartridges
pedagoji	pedagogy
prostat	prostate
yıldızgemisi	starship
ispinoz	finch
kalmak	stay
buzağılar	calves
olmadan	without
mahkeme	court
frengi	syphilis
damat	groom
irlanda	ireland
rotorlar	rotors
bibliyografik	bibliographic
indirilebilir	downloadable
yakalar	captures
denenmiş	tried
selanikliler	thessalonians
kovboylar	cowboys
günlükleri	logs
moritanya	mauritania
rahatlatıcı	relaxing
yapısal	structural
sendromlar	syndromes
tanımlamak	define
lamba	lamp
terminatör	terminator
korozyon	corrosion
duruşmalar	hearings
kons	conc
fabrika	factory
böyle	such
nikel	nickel
ağırlıklı	weighted
balayı	honeymoon
kaplanlar	tigers
kroki	sketch
gülümseme	smile
lanetleme	flipping
kameralar	cameras
tarihçiler	historians
kategorizasyon	categorization
dur	stop
plazmid	plasmid
tugay	brigade
dilerse	wills
dikişsiz	seamless
ağlar	networks
kavrulmuş	roasted
tanık	witness
güvercin	pigeon
hareket	motion
voltaj	voltage
forvet	striker
yetişkin	adult
amonyum	ammonium
yöntem	method
evet	yes
keşfedilen	discovered
yükselmek	rise
yazılı	written
yenilgiler	defeats
aktris	actress
inançlı	believer
kâşif	explorer
egzoz	exhaust
kolaylaştırma	facilitation
yakıt	fuel
öldürdü	killed
seyyar	mobile
delici	piercing
kültürlerarası	intercultural
sanık	accused
daktilo	typewriter
hidra	hydra
lezzet	flavor
sistem	system
endişelenmek	worry
karşılaştırma	compare
kıtlık	famine
kaytan	gimp
hepatit	hepatitis
bakteriler	bacteria
pazarlamacıların	marketers
boya	paint
uzak	distant
medine	medina
pençeler	claws
sentaz	synthase
savcılar	prosecutors
losyon	lotion
transferler	transfers
böğürme	moo
korkusuz	fearless
gece	night
paylaşılan	shared
belirtir	specifies
başarılar	achievements
diyetler	diets
yılan	serpent
kompozitler	composites
sicilya	sicily
revizyonları	revisions
dünya	world
çökmüş	collapsed
yular	halter
antilleri	antilles
varyasyonlar	variations
oyuncaklar	toys
düello	duel
katyon	cation
korkak	funky
istinat	retaining
üretmektedir	manufactures
simetrik	symmetrical
açıklayan	explaining
rusça	russian
derecesi	degree
karadağ	montenegro
binmek	ride
taç	crown
yöntemleri	methods
watt	watts
glikoprotein	glycoprotein
demiryolları	railways
koordinasyon	coordination
eskrim	fencing
davranış	behaviour
çıkarmak	eject
aptallar	fools
hızlandırıcı	accelerator
sektör	sector
garnizon	garrison
güneşler	suns
testler	tests
grönland	greenland
vadeli	term
taraflı	sided
algılayıcı	sensor
yükselecek	rise
benzersizlik	uniqueness
şöhret	fame
tutarsızlıklar	inconsistencies
kardeşler	siblings
tabletler	tablets
güncellenmesi	updating
şiir	poem
yapıları	structures
ihracat	export
telaffuz	pronunciation
sıçanlar	rats
münih	munich
indüklenmiş	induced
karakteristik	characteristic
uçuşlar	flights
fizyon	fission
eklemler	joints
mükemmelleştirilmiş	perfected
kot	jeans
oksitleri	oxides
osmanlı	ottoman
anne	mom
hantal	cumbersome
koniler	cones
şüpheli	suspicious
tanıtılan	introduced
kâkül	bangs
nöronal	neuronal
büyüleyici	charming
tükürmek	spit
balina	whale
serap	mirage
fasulyeler	beans
yardımlı	assisted
suçlama	blame
bip	beep
klişeler	stereotypes
buket	bouquet
pahalıya	dearly
sprey	spray
konsantreleri	concentrates
ciro	endorsement
sponsorlu	sponsored
mikrobiyal	microbial
ölçülebilir	measurable
zehir	poison
sabitleri	constants
monoklonal	monoclonal
yerleştirme	placement
asılı	hanging
mevzuat	legislation
genişler	expands
günbatımının	sunsets
not	note
tahmin	guess
granit	granite
tahlil	assay
erozyon	erosion
polislik	policing
finansman	funding
bolivya	bolivia
yıkanabilir	washable
seramik	ceramic
uçurtmalar	kites
hıfı	hifi
akış	flow
rotasyon	rotation
güldü	laughed
embriyolar	embryos
polinom	polynomial
tekrarlayan	recurrent
şube	branch
şans	chance
kaçtı	escaped
yanlış	wrong
kök	root
yazıcı	printer
bitirir	finishes
hizalamalarını	alignments
viroloji	virology
alerjik	allergic
mizaç	temperament
ayrım	distinction
gönüllüler	volunteers
timsah	crocodile
bıldırcın	quail
egzersiz	exercise
ormancı	forester
yaşayabilir	viable
yenilgi	defeat
şifoniyer	dresser
süpresör	suppressor
sığ	shallow
ambargo	embargo
ekipman	equipment
gölge	shadow
utanmaz	shameless
umutlu	hopeful
balkon	balcony
etek	skirt
sürşarj	surcharge
bölüm	chapter
iğneler	needles
kadın	woman
serin	cool
polimer	polymer
makale	article
kapma	grabbing
görüntü	image
sülün	pheasant
karşı	against
suratlar	smileys
eskilik	antiquity
kemik	bone
iblisler	demons
kuyruk	tail
açıkçası	frankly
ağaçlık	wooded
gözlem	observation
yoksulluk	poverty
kabuk	shell
dürbün	binoculars
akışkan	fluid
asil	noble
tuvalet	toilet
dut	mulberry
mantarlar	mushrooms
adaptörler	adapters
favök	ebitda
sabit	constant
niyet	intention
shirtler	shirts
dekorasyon	decoration
veda	farewell
fuhuş	prostitution
başucu	bedside
işyerleri	workplaces
ped	pad
vitaminler	vitamins
skolastik	scholastic
kemirgenler	rodents
sonat	sonata
bayiler	dealers
planlı	planned
dinamit	dynamite
yastıklama	cushioning
at	at
iskoçyalı	scottish
köpekbalığı	shark
acilen	urgently
bölüm	section
iştirakçi	contributor
değişkenlik	variability
roller	roles
anlayışlar	insights
konukevinin	inns
hükümetlerarası	intergovernmental
klanlar	clans
vinç	crane
epik	epic
amplifikasyon	amplification
kanlı	bloody
komisyon	commission
kalıp	mold
alternatifleri	alternatives
kolorektal	colorectal
can	can
soğanlar	onions
bayrak	flag
daireler	apartments
orakçı	reaper
kıvırcık	curly
tüberküloz	tuberculosis
itiraf	confession
deldi	pierced
zambak	lily
kompresör	compressor
hazineler	treasures
sıralamalar	standings
aks	axle
üzülerek	regrettably
stk'lar	ngos
omurgasızlar	invertebrates
gama	gamma
üstünlük	superiority
koçlar	coaches
tavanlar	ceilings
dağcı	climber
özbekistan	uzbekistan
bagaj	luggage
mesane	bladder
bezleri	glands
sarsılmış	shaken
evlât	scion
haftalık	weekly
bilekler	wrists
kullanıcı	user
besleyici	feeder
tezgahları	stalls
kırışıklıklar	wrinkles
rusya	russia
belirtildi	specified
kavram	concept
oran	rate
doğa	nature
kâtip	clerk
içkiler	beverages
hayır	no
halkalı	cyclic
olmaz	won’t
bıçaklar	knives
civciv	chick
veznedar	treasurer
haricen	externally
invazif	invasive
yastıklar	pillows
işaret	mark
inanmak	believe
yüce	sublime
basçı	bassist
safir	sapphire
sırplar	serbs
vatandaşlar	citizens
kuzeyinde	north
havari	apostle
parlak	bright
tören	ceremony
tatlım	sweetie
spiker	announcer
varmak	arrive
inşaatçılar	builders
plaka	plate
derece	degree
fotoğraflandı	photographed
gözetmen	supervisor
dezavantaj	disadvantage
iblis	demon
demek	say
sayılı	numbered
kütüphane	library
paketleme	packaging
depozito	deposit
ekonomistler	economists
primleri	premiums
seçim	choose
doyurucu	satisfying
çuhaçiçeği	primrose
arkadaş	friend
kronolojik	chronological
katarakt	cataract
farsça	persian
kampları	camps
inilti	moan
fotokopi	photocopy
sevinçle	joyfully
ambulans	ambulance
yatılı	boarding
muhasebeciler	accountants
primadonna	diva
fışkıran	gushing
escort	dating
taşındıktan	relocating
havalandırılan	ventilated
yiğit	valiant
yağ	oil
destekleyiciler	promoters
kısırlık	infertility
isveççe	swedish
kafatası	skull
hale	halo
tercihleri	preferences
körükler	blowers
rahipler	priests
çamurlu	muddy
algılandı	detected
manyak	maniac
pornografik	pornographic
yüzde	percent
engebeli	rugged
üzüm	grape
astroloji	astrology
tayland	thailand
askı	hanger
çanak	bowl
kuğu	swan
barok	baroque
memeler	nipples
ninni	lullaby
gecikme	delay
hilâl	crescent
ithalat	imports
katil	killer
geometri	geometry
özlem	longing
birisi	someone
budist	buddhist
işareti	sign
filistin	palestine
menşei	origin
katyonlar	cations
müzisyen	musician
gerilmeler	stresses
opak	opaque
biber	pepper
maliyetler	costs
bedenler	bodies
göz	eye
senin	your
antitröst	antitrust
aileleri	families
lejyon	legion
anabilgisayar	mainframe
adresleme	addressing
zamanlar	times
patikler	booties
bakiyeler	balances
iletilen	transmitted
seksen	eighty
mumcu	chandler
kelimeler	words
askerler	soldiers
külot	panties
dağ	mount
kaplumbağalar	turtles
dansçı	dancer
granüller	granules
yürütür	executes
bahisler	bets
kısayollar	shortcuts
transplantasyon	transplantation
seçicilik	selectivity
uzmanlar	experts
heyecanla	excitedly
destek	support
numaralama	numbering
nabız	pulse
dalay	dalai
celp	summons
yönlendirici	router
temalı	themed
tüketilir	consumable
alt	bottom
işlemler	transactions
sessizce	quietly
savaşlar	wars
eksiklik	lack
izle	watch
estrojen	estrogen
başla	start
yurt	dorm
zırh	armor
alıcıları	receivers
oktav	octave
konvansiyonel	conventional
politikacı	politician
aktivatör	activator
standartlar	standards
yorumcu	commentator
fatura	invoice
takviyeleri	supplements
gümrük	customs
tamamlanmamış	incomplete
yarım	half
top	ball
etilen	ethylene
domuz	pig
evlenmemiş	unmarried
milletvekili	deputy
harika	great
vurmalı	percussion
katalog	catalog
namert	craven
özdeğerler	eigenvalues
glakom	glaucoma
plutonyum	plutonium
seçmek	pick
sınav	exam
lavanta	lavender
milliyet	nationality
kırışıklık	wrinkle
saklamak	hide
konağında	townhouse
koyun	sheep
aynı	same
boyama	painting
aydınlatılmış	illuminated
müdür	manager
stadyum	stadium
reaktif	reagent
çeçenistan	chechnya
ücret	fee
esnaf	artisan
tablo	table
polimorfizmi	polymorphism
matkap	drill
uygulanabilirlik	applicability
belirleyicileri	determinants
karşısında	opposite
tetikleyiciler	triggers
korur	protects
eğri	curve
dinazorlar	dinosaurs
tedavi	treatment
oluşur	occurs
yanılmak	stumble
örneklenmiş	sampled
oğullar	sons
durdurulan	discontinued
eczacı	pharmacist
olağanüstü	exceptional
eşarplar	scarves
banyo	bathroom
gebelikler	pregnancies
genetik	genetic
tahminler	estimates
endotel	endothelial
kurbağa	frog
dikiş	seam
ödüller	awards
agonisti	agonist
krediler	loans
kişilik	personality
optik	optical
kukuletalı	hooded
farazi	hypothetical
nötron	neutron
ithal	imported
hapisteki	jailed
metaforlar	metaphors
doğru	correct
biçimlendirilmiş	formatted
toksikoloji	toxicology
lüteriyen	lutheran
asker	soldier
gecikmeler	delays
dürüst	honest
duyusal	sensory
atm'ler	atms
özet	summary
burun	nose
yorgunluk	fatigue
vandalizm	vandalism
inanır	believes
iddialar	allegations
botoks	botox
büyütme	magnification
engel	obstacle
yakalamak	catch
denetimler	inspections
çorba	soup
faz	phase
elçilikler	embassies
asimetri	asymmetry
ağustos	august
selsius	celsius
şaşkın	confused
verdi	gave
bacak	leg
piramit	pyramid
uyandırdı	aroused
implante	implanted
düştü	fell
trajedi	tragedy
okaliptüs	eucalyptus
tatlı	dessert
büyüme	growth
yenileme	renovation
bonservis	testimonial
madencilerin	miners
aracılı	mediated
atışları	shootout
ısmarlama	bespoke
bulmak	find
müstehcen	obscene
heyetler	delegations
çivilenmiş	nailed
simülatörleri	simulators
inceler	examines
yepyeni	brand-new
salgı	secretion
birleşmeyle	incorporating
meskenleri	dwellings
tersinir	reversible
cinayetler	murders
rutinleri	routines
iğfal	seduction
banklar	benches
salamura	brine
sismik	seismic
popülist	populist
oskar	oscar
mezmur	psalm
poz	exposure
kıta	continent
vazolar	vases
manyetik	magnetic
feribotlar	ferries
asitler	acids
gereksiz	unnecessary
zar	membrane
merakla	curiously
dedesi	grandparents
bazı	some
foton	photon
bölünme	division
itirazlar	objections
glütensiz	gluten-free
karışmak	interfere
anekdotlar	anecdotes
modeller	models
çifti	pair
çam	pine
atletik	athletic
aşırı	extreme
kapsül	capsule
bağıran	screaming
imrenme	envy
durdurmak	stop
kovalayan	chaser
tarifeli	scheduled
inme	stroke
penceresi	window
mikroskobik	microscopic
troller	trolls
lenf	lymph
söylentiler	rumors
iletkenler	conductors
akor	chord
pusula	compass
efsanevi	legendary
süreçler	processes
dirhemi	dirham
yasemin	jasmine
romantik	romantic
artırmak	increase
menteşeler	hinges
kare	square
ısınma	warming
daha	than
kurum	institution
maçlar	matches
klonlanmış	cloned
slaytlar	slides
ölen	dying
paradigma	paradigm
terminalleri	terminals
takas	swap
jaguarlar	jaguars
yapıştırılmış	glued
üç	three
toplayıcı	picker
kontrast	contrast
geliştikçe	evolves
checkin'leriniz	checkins
alışkanlıkları	habits
zürih	zurich
ham	crude
ıhlamur	linden
lokaliteleri	localities
zulüm	persecution
pervane	propeller
tava	pan
mobilya	furniture
zamanlanmış	timed
tiyatro	theater
mahzenler	cellars
asetil	acetyl
kombinasyonlar	combinations
aldatma	deception
etil	ethyl
baskıcı	oppressive
kötülük	evil
ayakkabı	shoe
önlükleri	aprons
ziyareti	visit
galeri	gallery
milyoner	millionaire
patlatır	exploits
sorunsal	problematic
kaçınılmaz	inevitable
peynir	cheese
bebeklik	infancy
denetimli	supervised
dan	from
rütbeler	ranks
ustalar	masters
yarımküre	hemisphere
kurutulmuş	dried
işgalciler	invaders
tahkim	arbitration
seçenekler	options
eğitilmiş	trained
cenevre	geneva
vardır	are
donmak	freeze
gerektirir	requires
teorem	theorem
dolar	dollar
almanak	almanac
önemsiz	insignificant
çıngırak	rattle
avcılar	hunters
piyon	pawn
güvenilmez	unreliable
bozulma	corruption
yapıcı	constructive
sigortasız	uninsured
kavisli	curved
taşeron	subcontractor
teftiş	inspection
belediye	municipality
değişkenler	variables
yapılmış	made
yarılma	cleavage
pipoları	bulldogs
yelkencilik	sailing
kampüsleri	campuses
ruhsatlı	licensed
notu	note
balçık	slime
iletir	transmits
oynanış	gameplay
marşlarının	anthems
huni	funnel
lazer	laser
oyun	game
karşılaştırılabilir	comparable
isimler	names
veya	or
ölü	dead
dövmeci	hammersmith
kombinatoryal	combinatorial
konferans	conference
uğrar	suffers
sempozyum	symposium
ermeni	armenian
zihin	mind
akciğer	lungs
etiketleme	labeling
rezil	infamous
karartma	blackout
radyasyon	radiation
ordinat	ordinate
substratlar	substrates
genellikle	generally
moda	fashion
dişiler	females
konfor	comfort
propan	propane
enerjik	energetic
resim	picture
çuval	sack
şükran	gratitude
bayım	sir
kuyrukluyıldız	comet
emizle	lear
römorklar	trailers
olanakdışı	improbable
istenilen	intended
edinburg	edinburgh
reaksiyonları	reactions
dokunuşlar	touches
karizma	charisma
jüpiter	jupiter
basitleştirilmiş	simplified
katkıda	contributed
mamut	mammoth
kaldır	remove
deneysel	experimental
üçlü	triple
saf	pure
yerleşimciler	settlers
kist	cyst
embriyonik	embryonic
türbin	turbine
patojen	pathogen
kuponlar	coupons
irrasyonel	irrational
analitiği	analytics
halsiz	sluggish
aranjman	arrangement
görüşler	opinions
doğumlar	births
ardışık	consecutive
boyut	size
çentik	notch
fotonik	photonics
genç	young
birmanya	burma
hatırlama	recall
enfeksiyonlar	infections
kalküta	calcutta
döngü	loop
otel	hotel
ibadet	worship
tanınmış	reputed
sondalar	probes
saldırgan	attacker
müslümanlar	muslims
kavramlar	concepts
ayrıcalıklı	privileged
programcılar	programmers
parlaklık	shine
kiracı	tenant
rezervler	reserves
zenginleştirilmiş	enriched
antropoloji	anthropology
yardımaraüyelertakvim	helpsearchmemberscalendar
hapishaneler	prisons
taktik	tactics
konuşma	speech
eğitimli	educated
deregülasyon	deregulation
palyaçolar	clowns
eşler	spouses
sapıkça	kinky
sarışınlar	blondes
titreyen	trembling
hidrokodon	hydrocodone
yükler	loads
nitelikler	qualifications
bildirim	notification
arttırıcı	enhancing
bilgisayarlı	computed
küp	cube
serbestçe	freely
kayıt	record
demiryolu	rail
dikkatlice	carefully
kârlı	profitable
hap	pill
bütün	whole
transseksüeller	transsexuals
sakallı	bearded
sömürge	colonial
aynalar	mirrors
savunmak	defend
aralayıcı	spacer
performansları	performances
dalgıç	diver
işlevselliği	functionality
estetik	aesthetic
gölgeleme	shading
genotip	genotype
rezervasyon	reservation
hassas	sensitive
defterler	notebooks
oranlar	ratios
tarihçe	history
teknikleri	techniques
emin	sure
eğreltiotu	fern
modası	fashions
nişasta	starch
yirmi	twenty
çırpılmış	whipped
taksonomik	taxonomic
sarkık	floppy
arasında	of
ondalık	decimal
işkence	torture
mutlu	happy
parasal	monetary
flanel	flannel
kovalamak	chase
nehirler	rivers
fantastik	fantastic
kıtık	tow
adenosin	adenosine
gümüş	silver
atomik	atomic
politikaları	policies
araştırıyor	explores
dedektifler	detectives
zımpara	emery
açıklıklar	openings
tarak	comb
milenyum	millennium
işadamları	businessmen
oynadığı	starring
yetiştirici	grower
düsseldorf'lu	dusseldorf
affetmek	forgive
filtreler	filters
heyelan	landslide
telefonlar	phones
sendrom	syndrome
istatistiksel	statistical
iş	job
iyileştirmek	improve
pervasız	reckless
bastonlar	canes
enstrümental	instrumental
konser	concert
varsayarak	assuming
meslekler	professions
kuşkonmaz	asparagus
dinamik	dynamic
kanat	wing
fauller	fouls
medeniyetler	civilizations
kilitler	locks
emekçiler	laborers
ralli	rally
ihtiyatlı	cautious
kolejler	colleges
hidroksit	hydroxide
yorulmaz	tireless
vaazlar	sermons
dağgelinciği	ferret
tepkiler	responses
hükümlü	convict
dabi	dhabi
aşinalık	familiarity
eşek	ass
çözmek	solve
soyadları	surnames
samimi	sincere
çığırtkan	barker
aile	family
yahudi	jewish
tarihsiz	undated
otantiklik	authenticity
pıo	pio
sıcak	warm
pompalar	pumps
şeker	candy
durdurucu	stopper
çoğaltılmış	replicated
broşür	brochure
cepler	pockets
gazeteci	journalist
bakteri	bacterium
sinekkuşu	hummingbird
iberya	iberia
ekler	adds
dönüşüm	transformation
aktar	transfer
salladı	shook
havuz	pool
göçmenler	immigrants
dalları	branches
başla	begin
yürekten	heartfelt
korsanlar	pirates
paslanmaz	stainless
kutsal	sacred
özelleştirilmiş	customized
koymak	lay
araba	car
ele	addressed
halkalar	rings
epidemiyolojik	epidemiological
stil	style
tavşanlar	rabbits
teoremler	theorems
denetleyici	supervisory
sürekli	continuous
inkontinans	incontinence
konveks	convex
balmumu	wax
venedik	venice
krem	cream
büfe	buffet
pencereler	windows
her	every
dünyevi	earthly
dövmek	beat
üreten	producing
raporlar	reports
cumhuriyet	republic
gri	grey
anjin	angina
ürdün	jordan
fener	lantern
rahatlamış	relaxed
kızma	tiff
inanan	believing
kriter	criterion
sinyalleri	signals
çizici	scribe
sitrat	citrate
kalp	heart
vicdanlı	conscientious
okumak	read
sosyolojik	sociological
öğlen	noon
pozitifler	positives
tartışma	talk
sermaye	capital
anılan	cited
formu	form
operaları	operas
listesi	list
farkında	aware
gözyaşı	tears
katıldı	joined
dedektörler	detectors
kira	rent
darbeler	blows
mimariler	architectures
kablolama	cabling
atlantik	atlantic
gerilimler	tensions
aydınlatmak	brighten
uyarlanmış	adapted
çiftlik	farm
uçan	flying
kapsam	scope
fırlatma	launching
diş	tooth
koridorlar	corridors
kadınsı	feminine
güveleri	moths
tuzluluk	salinity
sıkıştırılmamış	uncompressed
koylar	bays
terörizm	terrorism
ekstralar	extras
jest	gesture
konsolosluk	consular
korkulan	feared
taze	fresh
basınçları	pressures
gazeteciler	journalists
döndürmek	rotate
çıplaklık	nudity
afgan	afghan
olarak	as
yolcu	passenger
genişleyen	expanding
delme	drilling
bira	beer
çantalar	bags
segmantasyon	segmentation
atanmış	assigned
ayna	mirror
toplamak	gather
abone	subscriber
yönetmelik	regulations
puf	puff
canavar	monster
alışık	accustomed
ısıtır	heats
çatal	fork
konumlandırma	positioning
karpal	carpal
güç	power
uyarım	stimulation
duyulabilir	audible
boyutlandırma	sizing
enzim	enzyme
oyunculuk	acting
antidepresanlar	antidepressants
çatırtı	crunch
kriko	jack
insansız	unmanned
gösterme	showing
lipidleri	lipids
şekillenme	embodiment
afganistan	afghanistan
belirtilen	stated
benzin	gasoline
sezgi	intuition
şehir	city
makro-ekonomik	macroeconomic
budapeşte	budapest
sömürmek	exploit
ortopedik	orthopedic
ilhak	annexation
güvenilirlik	reliability
kavgalar	fights
berber	barber
yerleşim	residential
şimdi	now
soydular	robbed
onların	their
sönme	extinction
hidrolik	hydraulic
patron	boss
çare	resort
alakarga	jay
övdü	praised
iyonlaşma	ionization
fanteziler	fantasies
mamografi	mammography
insanlar	people
köle	slave
kurnazca	subtly
boksör	boxer
rasathane	observatory
animatör	animator
siyonist	zionist
etiyopyalı	ethiopian
kariyer	career
bulaşıcı	infectious
ulusal	national
robotik	robotics
hatırlamak	remember
edinilen	acquired
papatya	daisy
komedileri	comedies
hemşire	nurse
iraklılar	iraqis
otopsi	autopsy
manikür	manicure
vatanseverleri	patriots
tarçın	cinnamon
ev	home
havacılık	aviation
yerleşmek	settle
radyatör	radiator
yanıltıcı	misleading
kesilmemiş	uncut
harcamak	spend
toplantı	meeting
modemler	modems
sayma	counting
görüntüler	imagery
personel	staff
rezonant	resonant
zarafet	grace
öncüleri	pioneers
atmosferik	atmospheric
eldiven	glove
meraklı	curious
lavabo	sink
ayaklanmalar	riots
neşeyle	cheerfully
yakut	ruby
blazerler	blazers
fibromiyalji	fibromyalgia
delegasyon	delegation
üzerinde	on
akışları	streams
psikiyatrik	psychiatric
çöküş	collapse
tercihen	preferably
etkileşimler	interactions
günlük	daily
boykot	boycott
çözüm	solution
mutasyon	mutation
yalnız	lone
yeşillik	greens
önerir	recommends
benlikleri	selves
ezoterik	esoteric
aksine	unlike
kötü	poor
batıdan	westerly
reddedilen	rejected
akın	influx
fakülte	faculty
biyoinformatik	bioinformatics
ilerleme	progress
ticaret	trade
beceriksizlik	incompetence
patojenik	pathogenic
diyalekt	dialect
applet'ler	applets
baş	chief
kurtarıcı	savior
onbeş	fifteen
fanatikler	fanatics
dantelli	lacy
sızdırılmış	leaked
doğmuş	born
ıslık	whistle
kasiyer	cashier
derin	deep
nüler	nudes
sıvı	liquid
nijeryalı	nigerian
moratoryum	moratorium
onurlandıran	honoring
hoşçakal	bye
sakıncaları	drawbacks
parmaklar	fingers
dikizlemek	peep
gaydacı	piper
müteşekkir	thankful
ödüllendirilir	rewarded
blöf	bluff
eğer	if
yankıları	echoes
katlanılan	incurred
galaktik	galactic
kabanlar	coats
benimseme	adoption
vergileri	taxes
battaniyeler	blankets
dmw	wmd
dalgalar	waves
muhammed	mohammed
kömür	coal
düz	flat
raptiye	fastener
deprem	earthquake
alaşım	alloy
sesi	tone
varsayımlar	assumptions
katlanmak	endure
kılmak	render
tanımlar	definitions
dönemi	period
manifaturacı	draper
izleme	tracing
bilgikartı	flashcards
komutan	commander
afetler	disasters
yalıtımlı	insulated
parazit	parasitic
boyutlandırmak	resize
anayasalar	constitutions
yasaklar	prohibitions
muzaffer	victorious
kapanışları	closures
stewardlar	stewards
nükleer	nuclear
yağmurlar	rains
anglikan	anglican
ödemeler	payments
etiketler	labels
süt	milk
şişmiş	swollen
isteka	cue
davranır	treats
diskler	disks
kızlar	girls
kubbe	dome
yanıcı	flammable
mühürler	seals
kulüpleri	clubs
uygunsuz	inappropriate
zorlayıcı	compelling
güzelleşmek	flourish
esinti	breeze
vat	watt
dahil	include
nişanlar	insignia
fabrikalar	factories
yara	wound
süpermarket	supermarket
allah	god
kuart	quart
mistisizm	mysticism
dondurulmuş	frozen
radyatörler	radiators
hacim	volume
yerleri	locations
yakın	close
hırsızlar	thieves
tırnak	nail
kaçar	escapes
izolatlar	isolates
ünlüler	celebrities
referanslar	references
dev	giant
brezilya	brazil
rodos	rhodes
öldürücü	lethal
sarmalayıcıları	wrappers
mikroorganizmalar	microorganisms
saten	satin
kış	winter
analitik	analytical
devreler	circuits
bilgili	knowledgeable
aerobik	aerobic
alçıtaşı	gypsum
ölçeklenebilir	scalable
nötr	neutral
denizci	sailor
güvenlik	security
hala	still
şarkılar	songs
çözülmüş	solved
sarma	winding
golfçüler	golfers
nil	nile
yarasalar	bats
marul	lettuce
yakınlık	proximity
gevşeme	relaxation
pcmcıa	pcmcia
vampirler	vampires
değişmiş	changed
ne	what
diyakoz	deacon
tröstler	trusts
kısıtlanmamış	unrestricted
katıştırma	embedding
masum	innocent
aramalar	searches
posta	mail
amcıklar	cunts
mide-bağırsak	gastrointestinal
leopar	leopard
akıllıca	wisely
uzaylılar	aliens
tehlike	danger
kunduz	beaver
sayın	dear
tercüman	interpreter
teyze	aunt
var	got
arkeolojik	archaeological
yehuda	judas
kaybolmak	disappear
yalanlar	lies
meydana	occur
çanlar	bells
hareketsizlik	inactivity
akne	acne
aslan	lion
sübvansiyonlu	subsidized
minnettar	grateful
fırlatıcı	launcher
görgü	manners
kirkwood'un	kirkwood
truva	trojan
senkron	synchronous
çoğunlukla	mostly
istismar	exploitation
rahatlayın	relax
terriyer	terrier
paten	skate
şarkıcılar	singers
gana	ghana
gambiya	gambia
yavaşlatır	slows
patlıcan	eggplant
budizm	buddhism
nazik	gentle
alevler	flames
aktivizm	activism
kümes	coop
dissemine	disseminated
dedektif	detective
nehemya	nehemiah
varyant	variant
gölgeler	shadows
yol	way
spreyler	sprays
parfüm	perfume
atölyeler	workshops
etnografik	ethnographic
ünlem	exclamation
kirazlar	cherries
ay	month
sanatçılar	artists
kaldırım	sidewalk
oynanabilir	playable
fütüristik	futuristic
izlanda	iceland
filigran	watermark
koca	husband
kaşmir	cashmere
iştahla	heartily
kriptografi	cryptography
vaşak	lynx
lehim	solder
olgunluk	maturity
alpler	alps
ikili	binary
sert	hard
nefis	yummy
baskı	print
kurşun	lead
balıkçıl	heron
dilekçeler	petitions
naip	regent
ağaçlar	trees
başlatma	initiation
viskozite	viscosity
sincap	squirrel
bağımlıları	addicts
sorun	problem
entropi	entropy
korumasız	unprotected
çarpık	crooked
derecelendirilir	graded
halletmek	unzip
rektör	rector
ekin	crop
bölen	dividing
mesajlaşma	messaging
patenler	skates
transmembran	transmembrane
izin	permission
uyuşmuş	numb
katiller	killers
biyokimyasal	biochemical
sihirbaz	wizard
kenyalı	kenyan
yerine	rather
lâle	tulip
karakteristikleri	characteristics
belçikalı	belgian
azgın	randy
kurulamak	dab
kölelik	slavery
özellikler	features
döküm	casting
ruandalı	rwandan
pezevenk	fucker
kaynaklar	resources
egzotik	exotic
paletler	pallets
biyografiler	biographies
durdu	stood
toksisite	toxicity
iliştirmek	attach
tazı	greyhound
itiraflar	confessions
harcıyor	spends
aciz	incapable
evrim	evolution
moskova	moscow
tekdüzelik	uniformity
yaptırımlar	sanctions
oniks	onyx
kolsuz	sleeveless
alerji	allergy
topraklı	grounded
ölüm	death
çok	very
dişliler	gears
militan	militant
nokta	point
başak	spike
yaygara	fuss
sadık	loyal
buhar	vapor
dağlama	branding
eşit	equate
olasılık	possibility
veri	data
sibirya	siberia
çek	pull
bitirme	finishing
yakalandı	caught
kasılma	contraction
dayak	beating
ipeksi	silky
yazılım	software
tabu	taboo
dökümhane	foundry
seferler	expeditions
besteciler	composers
tutku	passion
bez	cloth
ağlayan	crying
kaydetmek	save
maskelemek	mask
tilkiler	foxes
çelenk	wreath
ventriküler	ventricular
taksit	installment
devre	circuit
senatörler	senators
kayısı	apricot
işveren	employer
köy	village
karaciğer	liver
direkt	direct
tasarımlar	designs
malzeme	material
kabinler	cabins
vapur	steamboat
seçenek	option
engeller	obstacles
marka	brand
kodlamak	encode
açık	open
mankenleri	dummies
tavsiyeler	recommendations
rupi	rupee
ortaklık	partnership
kodlama	coding
tatil	holiday
mucize	miracle
gider	expense
motivasyon	motivation
tasmaları	collars
organlar	organs
sözleşme	contract
belirlemek	determine
kıllar	hairs
boynuz	horn
antoloji	anthology
mentorların	mentors
organizasyonlar	organizations
sabun	soap
teknoloji	technology
losyonlar	lotions
kurtarmak	rescue
standardizasyon	standardization
sütun	column
takipçiliği	pursuits
mikron	micron
sübvansiyonlar	subsidies
hünerle	ably
felsefe	philosophy
elfler	elves
meşaleler	torches
müzakereler	negotiations
suçlular	criminals
bulanıklık	blur
varyans	variance
zurna	clarion
kaya	rock
algı	perception
kıt	scarce
hortum	hose
goblen	tapestry
üroloji	urology
primatlar	primates
uygulanabilir	applicable
kilometre	mile
mermer	marble
iddia	assertion
mandalina	mandarin
dielektrik	dielectric
kasalar	safes
piyanolar	pianos
sentezlenen	synthesized
rehabilitasyon	rehabilitation
çağlayan	cascade
müttefikler	allies
taşaklar	balls
okuyucular	readers
eylemler	actions
metan	methane
mimarlar	architects
elemeleri	qualifiers
kapsüllenmiş	encapsulated
evangelizm	evangelism
tripodlar	tripods
yenileyerek	renewing
kremler	creams
danışmanlık	consultancy
venezuela	venezuelan
çeviriler	translations
müşteriler	customers
işletmeler	businesses
kayaçlar	rocks
cenaze	funeral
basitlik	simplicity
yayınlanan	published
reaktör	reactor
akifer	aquifer
tolere	tolerated
hareketler	movements
oturdu	sat
öğretim	teaching
çelik	steel
skandal	scandal
görmek	see
şarkıcı	singer
reddeder	rejects
hissetmek	feel
diken	thorn
filarmonik	philharmonic
ısı	heat
elektrik	electricity
küçücük	tiny
dar	narrow
dokulu	textured
istasyon	station
sürükleme	dragging
çöpçatan	matchmaker
yüzücüler	swimmers
kreatin	creatine
eşitsizlikler	inequalities
kayak	ski
fotovoltaik	photovoltaic
haçlar	crosses
montajcı	assembler
penisilin	penicillin
semantik	semantics
siluet	silhouette
jinseng	ginseng
gazete	newspaper
ciddi	serious
kafa	head
köpük	foam
letonyalı	latvian
çiftleşme	mating
boru	pipe
dayanıklılık	durability
kaleler	castles
tarayıcılar	scanners
sulanan	irrigated
yatırım	investment
barbar	barbarian
güçlü	strong
it	push
acaba	wonder
denklemler	equations
viyana	vienna
sivrisinekler	mosquitoes
yarışçılar	racers
sindirim	digestion
moderatörler	moderators
vardı	had
mezun	graduated
ortak	common
amiraller	admiralty
benzen	benzene
imleçleri	cursors
taşıma	transport
konuk	guest
yaratık	creature
ilginç	interesting
helyum	helium
çivili	spiked
biyoetik	bioethics
alıntı	quotation
bloğu	block
pda'lar	pdas
banka	bank
çeviri	translation
titanik	titanic
holdingler	holdings
bin	thousand
açıcıları	openers
sandalet	sandals
donanımlı	equipped
kırsal	rural
harcanmış	spent
kalıplar	molds
etkileşim	interaction
tampon	buffer
sokma	insertion
genişlik	width
nakliye	shipping
enstitü	institute
eğreti	makeshift
ter	sweat
prolin	proline
ekstra	extra
adımlar	steps
cevap	answer
transeksüel	transsexual
ritimler	rhythms
maksimum	maximum
kıyılmış	chopped
haklar	rights
travmatik	traumatic
eskiden	formerly
kontrplâk	plywood
maydanoz	parsley
öğrencilerin	students
müdüriyet	secretariat
otobüsler	buses
göçük	dent
tabancalar	pistols
fideler	seedlings
kovalar	buckets
lazerler	lasers
mahkemeler	courts
uzlaştırmak	reconcile
saflık	purity
göç	migration
sistein	cysteine
kolay	easy
beyin	brain
gofret	wafer
sıkıca	firmly
kolaylaştırmak	facilitate
şırınga	syringe
organizmalar	organisms
rüzgarlar	winds
cumhuriyetçiler	republicans
hat	line
son	end
çemberler	hoops
nicel	quantitative
fenomenler	phenomena
teknolojik	technological
altmış	sixty
efesliler	ephesians
salak	idiot
farlar	headlights
doğurganlık	fertility
derlenmiş	compiled
izleyin	follow
tortu	residue
hardal	mustard
ortalamalar	averages
tanımsız	undefined
klonlama	cloning
perde	curtain
dönüştürücü	converter
bütçeleme	budgeting
bütünlük	integrity
zafer	victory
sporcular	athletes
hastalıklar	diseases
ısırmak	bite
neşter	lancet
filistinliler	palestinians
çimento	cement
anlamları	meanings
kavanoz	jar
itfaiyeci	fireman
biçimlendirici	formative
bak	look
girme	entering
izlenimler	impressions
çiğ	raw
almak	take
sunulan	presented
safkan	thoroughbred
karşılamak	meet
yıkayıcı	washer
şaşırmış	surprised
çubuklar	rods
sürdürülebilir	sustainable
bulut	cloud
polarize	polarized
kolaj	collage
frenler	brakes
glukozamin	glucosamine
hidrokarbonlar	hydrocarbons
vaizler	preachers
bariton	baritone
usta	master
sirke	vinegar
kışkırtıcı	provocative
eşitsizlik	inequality
dağıtır	distributes
özür	apology
toksinler	toxins
müzik	music
bütünleştirici	integrative
danışmak	consult
içerme	inclusion
lekeleri	stains
kasvetli	gloomy
dirsekler	elbows
iğrenç	disgusting
norveç	norway
asbest	asbestos
mifflin'in	mifflin
tanıtıcı	introductory
bungalov	bungalow
silecekler	wipers
eczaneler	pharmacies
armonika	harmonica
intihal	plagiarism
kolza	rape
vaha	oasis
derecelendirme	ratings
itibaren	from
oryantal	oriental
elektronik	electronic
tatlılar	desserts
kübik	cubic
memnun	glad
yunan	hellenic
biçilen	appraised
alay	regiment
tutsak	prisoner
kesim	cut
çemberci	hooper
helikopterler	helicopters
hareket	act
yerelleştirme	localization
seminer	seminar
dört	four
çubuk	rod
madde	matter
organizatör	organizer
esmerleşme	browning
karşıladı	greeted
klon	clone
glutamat	glutamate
teller	wires
emirler	orders
maruz	exposed
izotop	isotope
gülüyor	laughs
kontroller	controls
astronomik	astronomical
kılıçlar	swords
tevrat	torah
yaladı	licked
duvar	wall
adil	fair
listelenmiş	listed
yarışçı	racer
yeraltı	underground
delik	hole
sıfat	adjective
geçersiz	invalid
taşındı	moved
zina	adultery
kayboldu	disappeared
konuşmak	speak
proteaz	protease
özgüllük	specificity
şirketler	companies
alfabe	alphabet
taciz	abuse
gerçekleşme	realization
şehirarama	citysearch
tanrı	god
bombalama	bombing
senfoni	symphony
sakatlık	disability
makinalar	machinery
kadife	velvet
entellektüel	intellectual
yörünge	trajectory
çekmek	attract
fırçalanmış	brushed
minyatür	miniature
görevdeki	incumbent
vererek	giving
yatay	horizontal
limonata	lemonade
peluş	plush
kanadalı	canadian
periler	fairies
tarifeler	tariffs
apne	apnea
buzağı	calf
dernekler	associations
sodyum	sodium
soyunma	undressing
lateks	latex
pasifik	pacific
molekülü	molecule
televizyon	television
yığılmış	stacked
sözdizimsel	syntactic
iskemi	ischemia
boşanma	divorce
yıkama	washing
driscoll'de	driscoll
parçalayıcı	shredder
dönüş	turn
şafak	dawn
özendirici	incentive
vizör	viewfinder
maymunlar	monkeys
önde	ahead
bit	bit
rotalar	routes
arapça	arabic
brüksel	brussels
operasyon	operation
vinil	vinyl
çoğaltım	reproductions
kriz	crisis
kamboçya	cambodia
bariyer	barrier
rabıta	nexus
zorunlu	compulsory
rahatlatma	relieving
guguk	cuckoo
hazne	receptacle
milyon	million
taşıyıcılar	carriers
spekülasyon	speculation
semptom	symptom
kafaları	heads
kavanozlar	jars
zayıflık	weakness
sonuçlar	results
kerpeten	pliers
kefalet	bail
ile	with
nerede	where
gelişmek	thrive
formüller	formulas
asfalt	asphalt
düğmeleri	buttons
iştah	appetite
medyan	median
bırakın	leave
sosyal	social
pilotlar	pilots
kelebek	butterfly
vahşilik	brutality
kombo	combo
anahtar	key
uzun	long
matkaplar	drills
fosil	fossil
tanımlanamayan	unidentified
sondalama	probing
erken	early
mağaralar	caves
genom	genome
düşünür	thinker
domates	tomato
kodlayıcı	encoder
kendin	yourself
ekli	attached
okunabilirliği	readability
sepet	basket
davetiyeleri	invitations
kapsüller	capsules
sakıncalı	objectionable
kapanışlar	closings
mektup	letter
esmer	brunette
damping	dumping
utangaç	shy
bomba	bomb
kooperatifler	cooperatives
klinikler	clinics
termometreler	thermometers
meşru	legitimate
parfümler	perfumes
düşük	low
yalvardı	pleaded
muhbir	informant
tercümanlar	interpreters
cerrahlık	surgery
kaydedilmiş	recorded
ayrılmalar	separations
boncuk	bead
darülaceze	hospice
buzlu	iced
kalker	limestone
suçları	crimes
çubukları	sticks
ufuk	horizon
mikrosistemleri	microsystems
iç	internal
arabuluculuk	mediation
et	meat
boyunduruk	yoke
mistik	mystic
verilmiş	given
olur	happen
polipeptit	polypeptide
partizan	partisan
insafsızca	unfairly
kadar	far
kovboy	cowboy
kirlenmiş	contaminated
ünlü	vowel
su	water
hırpalanmış	battered
atamak	assign
memnun	satisfied
kaldırılabilir	removable
kullanılabilir	usable
nanoteknoloji	nanotechnology
ebe	midwife
açtı	led
mütevazi	modest
paslı	rusty
tabaka	layer
ekinoks	equinox
hikaye	story
merkezli	based
silindirler	rollers
pamukçuk	thrush
girişim	attempt
geçici	temporary
esrarengiz	enigmatic
yayalar	pedestrians
eksenleri	axes
sınırlamaları	limitations
zor	difficult
imzalı	signed
delikli	perforated
gelenler	arrivals
taşınabilirlik	portability
keser	cuts
klinik	clinic
karbit	carbide
bank	bench
özveri	devotion
atılmış	thrown
birleştirir	combines
onlar	they
sevgili	dear
ilçeler	counties
diplomatik	diplomatic
düz	plain
solcu	leftist
rotasyonlar	rotations
sakal	beard
meyveli	fruity
kabak	pumpkin
feragatnameler	disclaimers
demokratlar	democrats
baytkodu	bytecode
çizimler	drawings
çitler	fences
yazmak	write
bozdoğan	merlin
miyav	meow
istiridye	oyster
emtia	commodity
sarkom	sarcoma
benimsenen	adopted
do	do
gümbürtü	rumble
varyasyon	variation
liberalizm	liberalism
temas	contact
ölçüm	measurement
çocuk	children
dereotu	dill
çözücüler	solvents
bloker	blocker
birikmiş	accumulated
faks	fax
yüz	face
bahçıvanlar	gardeners
asteroitler	asteroids
entegratörleri	integrators
fobi	phobia
derinleştirmek	deepen
hastaneler	hospitals
çalkalama	agitation
taşıdık	ported
dışlanan	excluded
peyzaj	landscape
tarayıcı	scanner
cezalandırıcı	punitive
lüksemburg	luxembourg
sitokin	cytokine
argümanlar	arguments
tercihli	preferred
bağdat	baghdad
fakslar	faxes
analiz	analysis
yorumcular	reviewers
bayan	lady
mezunları	graduates
dilbilimsel	linguistic
okyanus	ocean
aşılar	vaccines
toplam	total
ispatları	proofs
dizileme	sequencing
noel	christmas
bilişsel	cognitive
adresler	addresses
hoşgörü	tolerance
kaybolur	disappears
dükkanlar	shops
şikâyetçi	complainant
şifa	healing
log	log
deneyim	experience
ayarlar	settings
kadırga	galley
tiryaki	addict
avrasyalı	eurasian
ons	ounce
bromit	bromide
uydu	satellite
enstrüman	instrument
röportaj	interview
linç	lynch
restoranlar	restaurants
göller	lakes
düşünmek	think
lahey	hague
yapamaz	don’t
germe	stretching
çüş	whoa
mandal	latch
karaya	ashore
görür	sees
neptün	neptune
sihirbazlar	wizards
ceketler	jackets
kaydırılır	shifted
skandallar	scandals
düzenleyiciler	regulators
hatlar	lines
antikor	antibody
kalori	calorie
lüks	luxury
kokarca	skunk
vardır	has
indirimli	reduced
mekanik	mechanical
kestane	chestnut
translasyonel	translational
buluşsal	heuristic
reçeteler	prescriptions
tekrarlar	repeats
muz	banana
zenginleştirme	enrichment
şifreleme	encryption
ticari	commercial
skleroz	sclerosis
silis	silica
bağlı	connected
kusurları	flaws
veritabanları	databases
değersiz	worthless
konteyner	container
toplamlar	totals
koşulsuz	unconditional
kurulmuş	established
süreklilik	continuity
artımlı	incremental
sözlükleri	dictionaries
tamamlayıcı	complement
götürülmüş	borne
kızışma	escalation
korse	corset
eleştirmek	criticize
araştırmacı	researcher
şikâyet	complaint
zatürree	pneumonia
estonya	estonia
demolar	demos
iyileştirmeler	improvements
çöl	desert
tükürük	saliva
gönderildi	sent
kesirli	fractional
yasal	legal
görüşmeler	interviews
sıralanmış	ranked
kaş	eyebrow
saptanabilir	detectable
brifingleri	briefings
kenevir	hemp
düşmanlık	hostility
kolon	column
fiiller	verbs
bataklık	swamp
süpürme	sweep
lidya	lydia
konfeti	confetti
hormon	hormone
birkaç	several
örümcekler	spiders
bağlılık	loyalty
salınım	oscillation
şeffaf	transparent
ayy	oops
uyanık	awake
birlikte	together
kapılar	doors
hücresel	cellular
azot	nitrogen
güçlendirmek	strengthen
sınıflarda	grades
otofokus	autofocus
jinekoloji	gynecology
üstel	exponential
israilliler	israelis
komisyonlar	commissions
yayılan	sprawling
genomları	genomes
bağımlılıklar	dependencies
metanol	methanol
dadı	nanny
akademiler	academies
uymama	noncompliance
ajanslar	agencies
direktif	directive
denize	overboard
bilinen	known
koordinatörler	coordinators
suistimaller	abuses
röleleri	relays
heyecan	excitement
sıcak	hot
gönderiler	shipments
ansiklopedi	encyclopedia
dominik	dominican
yağlar	oils
yararsız	useless
konnektörleri	connectors
trajediler	tragedies
bilezikler	bracelets
kalibre	caliber
pedleri	pads
kader	destiny
yüzdeler	percentages
teklif	offer
sunucu	server
tesisatçı	plumber
doldurucu	filler
sorumluluklar	responsibilities
selanik	thessaloniki
tutarlı	consistent
azimut	azimuth
fince	finnish
yorgancılık	quilting
öğütücüler	grinders
şımarık	spoiled
fikstür	fixture
fendimetrazin	phendimetrazine
kullanılmış	used
siyasi	political
tay	colt
denklik	equivalence
dosyalama	filing
aksesuarlar	accessories
abanoz	ebony
patogenez	pathogenesis
yama	patch
dikkatsiz	careless
sonraki	next
bileme	grinding
konakları	mansions
kıllı	hairy
gine	guinea
uykulu	sleepy
söylenti	rumor
hidroksi	hydroxy
uyarıyor	warns
menüler	menus
cebelitarık	gibraltar
banliyöler	suburbs
akut	acute
kurnaz	cunning
sipariş	order
fakülteler	faculties
bor	boron
lezzetli	delicious
ateşleme	ignition
altyazılar	subtitles
hesaplamalar	calculations
farmasötik	pharmaceutical
westernler	westerns
hızlandırmak	accelerate
zaman	when
geçitli	gated
dozlar	doses
bardak	glass
zodyak	zodiac
hizip	faction
keşfetmek	discover
tabanca	gun
stabilizasyon	stabilization
vidalar	screws
dikişler	seams
saygılar	respects
ters	reverse
çeşnili	flavored
algılanan	perceived
ipotek	mortgage
biyofizik	biophysics
atriyal	atrial
atomudur	atom
tarafından	by
tutkulu	passionate
polikarbonat	polycarbonate
küpler	cubes
oşinografi	oceanography
mesleki	vocational
teklif	bid
mutfak	kitchen
ezik	meek
güçlendirdi	strengthened
takipçileri	followers
iskelet	skeleton
sportif	sporty
polifonik	polyphonic
denetim	audit
hematoloji	hematology
orospular	bitches
katılan	participating
hile	trick
gayler	gays
kısayol	shortcut
yoğunluk	density
kazanılmış	vested
suç	crime
bulaşıklar	dishes
lif	fiber
halojen	halogen
derleyiciler	compilers
imzasız	unsigned
tükenme	exhaustion
oldu	was
donuk	dull
hamak	hammock
kozmopolitan	cosmopolitan
sıhhi	sanitary
arsenik	arsenic
kıtalar	continents
dökülmüş	poured
flört	flirt
yabancılaştırma	alienation
veba	plague
görkemli	splendid
hububat	cereals
uçak	airplane
dostluklar	friendships
entegre	integrated
hırs	ambition
devrim	revolution
podyum	podium
terapist	therapist
hariç	except
biçimsel	formal
sevinmek	rejoice
manuel	manual
duş	shower
fransa	france
açıklayıcı	explanatory
korkunç	terrible
projektörler	projectors
büyük	grand
coğrafya	geography
olmadıkça	unless
sürüngenler	reptiles
asistan	assistant
süs	ornamental
tayfun	typhoon
spektrumları	spectra
prestij	prestige
incir	fig
logolar	logos
olaylar	events
keman	violin
kompakt	compact
alkolikler	alcoholics
bayat	stale
ekvator	equator
öngörülemeyen	unpredictable
salatalık	cucumber
şelale	waterfall
kargalar	crows
taranan	scanned
fırtına	storm
kardinaller	cardinals
yazıcılar	printers
kalkanlar	shields
içeriyordu	contained
sörf	surf
bırakın	drop
bağbozumu	vintage
kolonizasyonu	colonization
ringgiti	ringgit
hayırseverlik	philanthropy
ay	moon
klavyeler	keyboards
miktar	quantity
yayımcı	publisher
zahmet	bother
girdap	whirlpool
elektrolit	electrolyte
pompalama	pumping
saçma	absurd
çökeltme	precipitation
oluklar	grooves
varış	arrival
hapis	prison
msj	msgs
çocukça	childish
öykücü	storyteller
topografya	topography
gitmek	go
ilaçlar	medicines
gitar	guitar
mizah	humor
baskılar	prints
klips	clip
voltajlar	voltages
ateroskleroz	atherosclerosis
duygusal	emotional
fiil	verb
firari	fugitive
yonca	clover
yorumlama	interpretation
tarım	agriculture
kip	mode
homoloji	homology
mısırlılar	egyptians
kaybetti	lost
satıcı	seller
coşmuş	rampant
konsantrasyonlar	concentrations
avcılık	hunting
açıkları	deficits
turlar	tours
yolculukları	cruises
vites	gear
kentsel	urban
kemoterapi	chemotherapy
barışçıl	peacefully
bilgi	information
alkış	applause
kostüm	costume
hastane	hospital
metal	metal
iyilik	favor
analoji	analogy
çokgen	polygon
uygun	fit
beyazlatma	whitening
kanca	hook
şnorkel	snorkel
çarpıcı	stunning
sponsorluklar	sponsorships
saunalar	saunas
interlüd	interlude
emanetçi	depository
yorgun	tired
savunur	defends
fiyatlandırma	pricing
hacimleri	volumes
sevap	mitzvah
hazır	ready
çeteler	gangs
boğazlar	straits
yapıştırma	bonding
israil	israel
gönderilen	sent
arazi	land
metrik	metric
duymak	hear
diplomalar	diplomas
eloksal	anodized
kasıtlı	intentional
arıza	fault
sabahları	mornings
toplumlar	societies
heykeltraş	sculptor
fırtınalı	stormy
ezmek	crush
devletler	states
grip	flu
içgüdü	instinct
anoreksi	anorexia
karmaşa	complexity
ortaklaşa	jointly
birincil	primary
parlaklık	brightness
güvenen	trusting
söğüt	willow
reorganizasyon	reorganization
yaz	summer
sağlıklı	healthy
patronları	patrons
albüm	album
gruplamalar	groupings
genişletilmiş	extended
umut	hope
diz	knee
avukat	attorney
anatomi	anatomy
farklı	different
tayvanlı	taiwanese
ispanyol	spanish
ulaşmak	reach
sürtünme	friction
ikincisi	latter
üniformalar	uniforms
müstahzarlar	preparations
piton	python
duman	smoke
yatak	bed
zanaat	craft
kusma	vomiting
kuluçkalanmıştır	incubated
fotometri	photometry
canlandırılmış	animated
şişirilmiş	inflated
içermek	contain
etnik	ethnic
analist	analyst
yanıklar	burns
kaplamalar	coatings
yastık	pillow
ekonomi	economy
overclock	overclocking
tuzlu	salty
resepsiyon	reception
düğün	wedding
epidemioloji	epidemiology
salgınlar	outbreaks
odaklanma	focusing
kirişler	beams
yanma	combustion
kuzenler	cousins
tarihli	dated
taramak	scan
halı	carpet
ayırıcı	separator
albümin	albumin
günahlar	sins
içki	drink
çarşaflar	sheets
yaratıcıları	creators
yaralar	wounds
ihlalleri	violations
yağsız	lean
elek	sieve
sevme	liking
hevesle	eagerly
köşeleri	corners
multimedya	multimedia
sonuçlandı	resulted
sürgün	exile
yapılandırarak	configuring
krizler	crises
görevler	tasks
kaliforniyalı	californian
kurtarma	recovery
hızlandırıcılar	accelerators
distribütörler	distributors
ithalatçı	importer
altıncı	sixth
edebiyat	literature
adres	address
isteklilik	willingness
sandalye	chair
taşıyıcı	carrier
üstlendi	undertook
tırmanıyor	climbs
listeleri	lists
steroidler	steroids
dram	drama
indeks	index
teleks	telex
seyreltik	dilute
bulaştırmak	infect
ülke	country
mavna	barge
güncellemeler	updates
izci	scout
ikinci	second
işsizlik	unemployment
algılamalar	perceptions
kabine	cabinet
bok	shit
emekliler	retirees
uluslararası	international
sakinleri	residents
önerdi	suggested
düzenli	regular
çekmece	drawer
pil	battery
kartalgiller	falcons
kuyruk	queue
okutman	lecturer
kaptan	captain
hafifletilmesi	easing
finalistler	finalists
başyapıt	masterpiece
biseksüel	bisexual
villalar	villas
gökyüzü	sky
kum	sand
ekolayzer	equalizer
pnömatik	pneumatic
bahçe	garden
boncuklar	beads
paradoksal	paradoxically
köyler	villages
onlarca	dozens
haşhaş	poppy
morfoloji	morphology
fıtık	hernia
manşet	cuff
yüksekler	highs
rutin	routine
çözümlenmemiş	unresolved
özgürlükçü	libertarian
terörist	terrorist
oksidasyon	oxidation
sığırlar	cattle
kronikler	chronicles
koma	coma
polarizasyon	polarization
karşılaştırmalar	comparisons
danimarka	denmark
mutemet	fiduciary
vergilendirme	taxation
kanyon	canyon
okçuluk	archery
maaş	salary
esmerler	brunettes
özyinelemeli	recursive
bilinçli	conscious
giderler	expenses
defne	bay
dinleyici	listener
parite	parity
yasalaştırılan	rulemaking
piyango	lottery
tahıl	grain
buzullar	glaciers
soykırım	genocide
duyurmak	announce
fotoğrafçılar	photographers
çeşme	fountain
eksi	minus
beslenme	nutrition
kukuleta	hood
fırıncı	baker
kapalı	off
piyangolar	lotteries
rustik	rustic
kaledonya	caledonia
acıklı	pathetic
defin	burial
üretir	produces
flamenko	flamenco
sosyalizm	socialism
ilahi	divine
malezya	malaysia
sahneler	scenes
sadece	just
maya	yeast
kızgın	angry
atıklar	wastes
metamfetamin	methamphetamine
ritmik	rhythmic
dürtüleri	urges
kol	arm
barındırma	hosting
hareket	move
çerçeve	frame
antioksidan	antioxidant
puan	score
sızma	infiltration
gri	gray
sponsorlar	sponsors
çimenli	grassy
yeni	new
değinir	cites
üre	urea
gitti	went
tonerler	toners
araç	vehicle
şablonları	templates
konteynerler	containers
çedar	cheddar
dikey	vertical
akreditasyon	accreditation
toleranslar	tolerances
dilbilim	linguistics
tasarımcı	designer
meli	should
uyanmış	awakened
gevşemek	unwind
mola	break
bitmemiş	unfinished
duşlar	showers
kaçakçılık	smuggling
yakından	closely
zayıflatmak	weaken
binici	rider
içten	internally
pişmanlıklar	regrets
kozmik	cosmic
karşılaştırmak	compare
ördek	duck
kendilerini	themselves
üretken	productive
kulaklar	ears
kanatlı	winged
eza	calvary
orada	there
teksas	texas
yumurtalık	ovarian
fraksiyonlar	fractions
silindir	cylinder
anabolik	anabolic
payanda	strut
arpa	barley
fosfor	phosphorus
tepsileri	trays
düşünülemez	unthinkable
kürek	shovel
odaklı	focused
liste	list
sınıflar	classes
konfederasyon	confederation
cenin	fetus
ikramlar	refreshments
tromboz	thrombosis
narenciye	citrus
nötrino	neutrino
bulundu	found
civcivler	chicks
şaheserleri	masterpieces
geçirgenlik	permeability
çok	too
eşik	threshold
barones	baroness
kaplanmış	coated
cahil	ignorant
ritim	rhythm
harfle	capitalized
selvi	cypress
satürn	saturn
pastaneler	bakeries
kürler	cures
nezaret	supervision
annelik	motherhood
kontrolsüz	uncontrolled
dengesiz	unbalanced
geçim	livelihood
paketleyicisine	packager
kapakçık	valve
kalpler	hearts
aslında	actually
saldırganlar	attackers
kalıtsal	hereditary
iflaslar	bankruptcies
taçyaprağı	petal
arama	search
şişmanlık	obesity
uzmanlaşmak	specialize
aristo	aristotle
siyaset	politics
selenyum	selenium
içgörü	insight
koşmak	run
konsültasyon	consultation
sandviç	sandwich
yayıncılık	publishing
hayvanlar	animals
reddetti	refused
kavramsal	conceptual
gevşek	loose
kalıntılar	ruins
yumurta	egg
olağan	usual
boks	boxing
kırpma	crop
tamsayılar	integers
damıtık	distilled
hakkıyla	duly
yapıştırmak	paste
bavyera	bavaria
borçlanma	borrowing
çoğaltılamaz	duplicated
baltık	baltic
liman	port
kaplan	tiger
tamlık	completeness
gerçekler	truths
halef	successor
eşikler	thresholds
onuncu	tenth
biyologlar	biologists
modüller	modules
sıralamaları	rankings
pornografi	pornography
tazminat	compensation
rampalar	ramps
uzuv	limb
sayfalar	pages
kupon	coupon
palet	palette
züccaciye	glassware
basit	simple
birleşmiş	united
beklenti	expectation
fransızca	french
alâmet	omen
faktör	factor
düzenleri	layouts
britanya	britain
korunan	guarded
valiler	governors
defalarca	repeatedly
anında	instantly
güverte	deck
sözcü	spokesman
stroboskop	strobe
yürüyüşleri	walks
lavman	enema
ahlaksız	immoral
belirleyen	determining
hazırlanmış	prepared
protokolleri	protocols
kabuslar	nightmares
federasyon	federation
antidepresan	antidepressant
açıklamalı	annotated
kaydırıcı	slider
akıllı	smart
etkilendim	impressed
resifleri	reefs
görüntülenebilir	viewable
kraliçe	queen
ebelik	midwifery
anestezi	anesthesia
dönülemez	irreversible
ütopya	utopia
tamamen	completely
otomatikleştirilmiş	automated
güçler	forces
ferahlatıcı	refreshing
kütüphaneler	libraries
minimize	minimized
zehirlenmiş	poisoned
floş	flush
tamilce	tamil
arasında	between
ikiz	twin
voleybol	volleyball
dudak	lip
birim	unit
prag	prague
yelken	sail
çocuk	boy
alçakgönüllülükle	modestly
derinden	deeply
bombalar	bombs
aksanlı	accented
merkezileşmiş	centralized
kumar	gambling
giyme	wearing
içenlerin	drinkers
yalıyor	licks
semitik	semitic
bileşimler	compositions
don	frost
emek	labor
beslemeleri	feeds
eşkıya	bandit
nesir	prose
işletme	operating
nöronlar	neurons
emülatörü	emulator
çalıştırıcı	actuator
kokteyller	cocktails
çakra	chakra
hiyerarşileri	hierarchies
kriket	cricket
kalabalık	crowd
sürdürülemez	unsustainable
özetleri	summaries
diktatörlük	dictatorship
natüralist	naturalist
zahmetli	troublesome
var	have
eşleşti	matched
tezahürat	cheer
kavun	melon
römorkör	tug
sarkıtmak	dangle
konferanslar	conferences
ajan	agent
evsiz	homeless
dergi	magazine
çeyrek	quarter
çıplak	naked
inch	inch
akılsız	mindless
ağırlıyor	welcomes
blogcular	bloggers
tahsisler	allocations
çavuş	sergeant
pozlar	poses
herkül	hercules
bantlanmış	taped
akademik	academic
senaryo	scenario
bağırsak	bowel
geçit	passage
kutuplar	poles
güneydoğu	southeast
toplantılar	meetings
dansçılar	dancers
kaçırma	kidnapping
tuna	danube
depolama	storage
modüler	modular
uyku	sleep
icar	letting
kurtulmuş	rid
nüfus	population
likra	lycra
tatlar	flavors
mermerler	marbles
üniseks	unisex
ödenecek	payable
yaratıcılık	creativity
karmaşıklıklar	complexities
ilkel	primitive
benzerlik	similarity
kablosuz	wireless
çalıkuşu	wren
cilalama	polishing
sihirle	magically
yüksek	high
güvensiz	insecure
kademeli	gradual
plasenta	placenta
sıralar	sorts
edinme	acquisition
örnekleyici	sampler
şampiyonluk	championship
tekmeledi	kicked
tüccar	merchant
tanımlayıcıları	identifiers
eski	old
battı	sank
somon	salmon
müzikaller	musicals
gözlemci	observer
muayeneler	examinations
kasklar	helmets
ahtapot	octopus
videografi	videography
kaos	chaos
limuzinler	limousines
üretmek	produce
yağlayıcılar	lubricants
beklentiler	expectations
tahminci	estimator
kartpostal	postcard
mısır	corn
formasyon	formation
anatomik	anatomical
çevrili	surrounded
yazık	pity
silme	deletion
emisyonları	emissions
külliyat	corpus
astarlı	lined
müzayedeler	auctions
müzakere	negotiation
omuz	shoulder
kusurlar	defects
mutsuz	unhappy
fabrikasyon	fabricated
vejetaryen	vegetarian
uzaklıklar	offsets
düşülebilir	deductible
döşemeli	upholstered
dosya	file
payda	denominator
gösterisi	show
dönüştürülmüş	converted
çarpmak	multiply
oluşturmak	create
ülkeler	countries
çözünme	dissolution
kıvılcım	spark
verimlilik	productivity
ayıklanıyor	extracting
soyutlama	abstraction
boyunca	throughout
içecek	beverage
yerli	domestic
yarda	yard
azalmalar	reductions
katılıyor	attending
ayıkla	extract
yakınsamak	converge
modellenmiştir	modeled
geri	back
kohortlar	cohorts
nostalji	nostalgia
yansıtır	reflects
satış	sales
doğrulama	verification
sembolizm	symbolism
binlerce	thousands
cevap	reply
transformatör	transformer
yoğunlaşarak	concentrating
sefil	miserable
hizalanma	alignment
ilişkisel	relational
geometrik	geometric
kamış	reed
çarpıtma	distortion
mızraklar	spears
minik	tiny
eşlik	accompaniment
düşmanları	enemies
atlayışlar	jumps
macera	adventure
taşımacılık	transportation
enstrümanlar	instruments
pasaportlar	passports
gün	day
rodyum	rhodium
bileşikler	compounds
broşürleri	leaflets
bitki	plant
atıcı	shooter
kitapçılar	bookstores
bağlam	context
şilteler	mattresses
süpürüldü	swept
infotrac'ı	infotrac
karşılıklılık	reciprocity
isabetler	hits
teknisyen	technician
değerlendirmeler	assessments
çıktıları	outcomes
roket	rocket
rulet	roulette
konumlandırılmış	positioned
menekşe	violet
dilimleri	slices
diriliş	resurrection
milliyetçilik	nationalism
koordinat	coordinate
amoksisilin	amoxicillin
fosforilasyon	phosphorylation
salaklar	idiots
profesyonel	professional
depremler	earthquakes
maliyet	cost
asiklovir	acyclovir
ilgisiz	irrelevant
kazanlar	boilers
bol	plenty
düzensizlikler	irregularities
amonyak	ammonia
hidrokarbon	hydrocarbon
mcı	mci
analık	maternity
etkilemek	affect
kısım	portion
diğerleri	others
sürünen	creeping
mağaza	store
seralar	greenhouses
kumlu	sandy
kül	ash
bujileri	plugs
zefir	zephyr
kocaman	huge
konvoy	convoy
dalış	dive
itiraz	objection
savunmasız	vulnerable
almak	receive
gadget'lar	gadgets
termometre	thermometer
eğitmenler	trainers
pullar	stamps
sorgulama	questioning
kızıllar	redheads
şekerler	sugars
ısırıkları	bites
yüzyıl	century
kısaltılmış	abbreviated
bebekler	babies
duygu	emotion
cerrah	surgeon
tomografi	tomography
sakkaromises	saccharomyces
çürük	rotten
şaraplar	wines
derlemek	compile
torrentler	torrents
düz	straight
temizler	cleans
kıbrıs	cyprus
neyse	anyways
kazara	accidentally
atomları	atoms
şüpheci	skeptical
çerçeveleme	framing
distrofi	dystrophy
emeklilik	pension
geyşa	geisha
yapboz	jigsaw
kırıntıları	crumbs
izler	marks
tahriş	irritation
yetkililer	authorities
öğretmen	teacher
bağlamak	connect
kökünden	radically
hidro	hydro
ısıttı	warmed
bürokrasi	bureaucracy
gun	gun
kinetik	kinetic
diasporası	diaspora
polarite	polarity
uygulamalı	applied
alanlar	areas
nihai	final
yükümlülükleri	obligations
koordinatör	coordinator
elâ	hazel
başlar	starts
hedef	target
şilin	shilling
cebrail	gabriel
ardılları	successors
portreler	portraits
kamboçyalı	cambodian
paneller	panels
arşiv	archive
çakmaklar	lighters
kitaplar	books
kent	city
sağlam	sturdy
yağmur	rain
akıncılar	raiders
marangozlar	carpenters
kanada	canada
oyma	carving
konu	subject
çit	fence
şok	shock
dozaj	dosage
kabartılmış	embossed
mutabakat	reconciliation
yapılandır	configure
bitişik	adjacent
onu	her
bölme	chamber
doldurmak	fill
soymak	rob
programlama	programming
virüs	virus
garantili	guaranteed
semptomatik	symptomatic
argo	slang
ergenlik	puberty
maliye	finance
konuşlu	stationed
gerçekçilik	realism
ormanlar	forests
kohort	cohort
sinirsel	neural
evet	yeah
kanyonlar	canyons
bulgu	finding
televizyonlar	televisions
tür	kind
anlamsız	meaningless
karibu	caribou
asidik	acidic
geto	ghetto
karışık	mixed
yanmış	burned
yükselt	upgrade
eşzamanlı	simultaneous
kafesler	cages
editör	editor
platin	platinum
uzaklaştırma	removal
fransisken	franciscan
bağırışlar	shouts
tasarımcılar	designers
jeotermal	geothermal
havai	overhead
protonlar	protons
mahşer	armageddon
irak	iraq
kinaz	kinase
antenler	antennas
sıkı	tight
patenci	skater
tabakçı	tanner
hırsları	ambitions
nimet	blessing
cts	sat
önlenmiş	prevented
alev	flame
destekleyici	supportive
bombacı	bomber
hasar	damage
kazananlar	winners
olsa	though
yaşlılar	elders
değiştirme	changing
fahri	honorary
köylü	peasant
meşale	torch
platformlar	platforms
kama	wedge
dolaştırılan	circulated
restore	restored
ilişki	relationship
homojen	homogeneous
heybetli	imposing
kalınlık	thickness
utanç	shame
balıkkartalı	osprey
sempatik	sympathetic
kulis	backstage
mekanizmalar	mechanisms
tadil	amended
cilt	skin
kibarca	politely
sanırım	guess
nijer	niger
mürekkepler	inks
tesis	facility
boyutlar	dimensions
çaresiz	helpless
kolayca	easily
kısa	short
keklik	partridge
oksidaz	oxidase
operatörler	operators
yinelenen	recurring
rezervuarlar	reservoirs
arkaik	archaic
yaygınlık	prevalence
adanmış	dedicated
yüzücü	swimmer
bloklar	blocks
iğrenme	disgust
sayılar	numbers
mplayer'dan	mplayer
işbirliği	cooperation
onu	him
korsika	corsica
boğaz	throat
bağlantılar	links
tebrikler	congratulations
diğer	other
kalmıştır	remained
karotis	carotid
eşitsiz	unequal
kıskanç	jealous
canlandırmak	revive
konsorsiyum	consortium
takasları	swaps
tamamladıktan	completing
düşman	foe
izciler	scouts
çarşı	bazaar
emmek	suck
figürinler	figurines
onaltılık	hexadecimal
dobra	raunchy
bulgar	bulgarian
nisan	april
sezgisel	intuitive
sorumsuz	irresponsible
analistler	analysts
kapitalizm	capitalism
tamponlama	buffering
yedi	seven
astronom	astronomer
işitme	hearing
zoofili	zoophilia
adalı	islander
jeolojik	geological
toplar	collects
kahverengi	brown
kiralamalar	leases
rulman	roller
cihat	jihad
rüzgarlı	windy
portekiz	portugal
temmuz	july
lig	league
yapılandırma	configuration
domuzlar	pigs
adam	man
buhar	steam
savunma	defense
kodlu	coded
ada	island
çarpışmak	collide
mağara	cave
idealler	ideals
mühürlü	sealed
genişbant	broadband
kaleci	keeper
sergileyen	displaying
primerler	primers
günahkâr	sinner
yakıcılar	burners
analogları	analogs
multipleks	multiplex
ipod'lar	ipods
kek	cake
sihirli	magic
sakızlar	gums
sıfır	zero
farklılaştırma	differentiation
gezenek	locus
demiryolu	railway
vardiya	shift
uzunlukları	lengths
kanepeler	sofas
kuyular	wells
traktörler	tractors
apollon	apollo
kahraman	hero
açıkladı	explained
beyefendi	gentleman
politeknik	polytechnic
fiziksel	physical
penguen	penguin
diledi	wished
ince	fine
havyar	caviar
inekler	cows
döner	rotary
peruklar	wigs
bakara	baccarat
ilyas	elijah
kapsamlı	comprehensive
deformasyon	deformation
ritüeller	rituals
nitelemek	qualify
vakalar	cases
piller	batteries
maraton	marathon
büzülür	shrinking
tanımlayıcı	descriptive
incelenen	examined
putperest	pagan
olsun	whether
haber	news
mum	candle
yorgan	quilt
evlilik	marriage
büyücülük	witchcraft
ödenekleri	allowances
klor	chlorine
astronomlar	astronomers
küller	ashes
şaman	shaman
takvimler	calendars
davranışlar	behaviours
yiyiciler	eaters
duyarsız	insensitive
azalmış	decreased
demlemek	brew
dermatoloji	dermatology
nitelikli	qualified
koruyucuları	protectors
aptallık	stupidity
liberaller	liberals
hakim	judge
filipililer	philippians
iflas	bankruptcy
giyinmiş	dressed
dikkat	attention
üyelik	membership
eritilmiş	melted
rehin	pledge
epilepsi	epilepsy
raflar	shelving
iletilebilir	communicable
seçmek	choose
gözenekli	porous
haddelenmiş	rolled
karısı	wife
geçerli	valid
topak	pellet
konuşmaları	conversations
öğretileri	teachings
önümüzdeki	forthcoming
işareti	mark
ateist	atheist
rüzgar	wind
çareler	remedies
sovyet	soviet
fonksiyon	function
reaksiyon	reaction
onadı	upheld
vekil	proxy
avam	commons
çömlekçilik	pottery
viski	whiskey
win	win
fırsat	opportunity
yankılandı	echoed
kuveyt	kuwait
enayi	sucker
kınamak	condemn
yapılandırılmış	structured
lezbiyen	lesbian
nadiren	rarely
körlük	blindness
köpüklü	sparkling
uyumsuzluk	mismatch
koloseliler	colossians
indirimler	discounts
asansör	elevator
izlemek	watch
arjantin	argentina
saldırganlık	aggression
sofistike	sophisticated
ortalama	average
gerici	reactionary
demokrasi	democracy
önkoşullar	prerequisites
dönülmüş	revisited
ressam	painter
ikonik	iconic
transdüksiyon	transduction
eleştiri	criticism
hayaletler	ghosts
filmler	movies
zorlamak	enforce
esrar	marijuana
alıcı	receiver
metodolojik	methodological
konut	housing
egzersizleri	exercises
dondurucu	freezing
mikrofonlar	microphones
başladı	began
pozisyon	position
baskın	raid
melodileri	tunes
bukalemun	chameleon
pratik	practical
yatırımcı	investor
misilleme	retaliation
feminizm	feminism
ardıç	juniper
mükellefler	taxpayers
boynuzlu	horned
çıkarmak	subtract
başvurulan	referenced
normlar	norms
ligandlar	ligands
şanslı	lucky
laminat	laminate
kıymıklar	flinders
tanıdık	familiar
yetkisiz	unauthorized
kesintisiz	uninterrupted
korvet	corvette
hidrasyon	hydration
hotspot'lar	hotspots
anaerobik	anaerobic
ajanları	agents
ödeme	pay
gecikmiş	delayed
temettüler	dividends
zeplin	zeppelin
yanak	cheek
önceki	previous
âyetlerini	revelations
maç	match
memnuniyetle	gladly
lösemi	leukemia
lokomotifler	locomotives
yalnızlık	loneliness
yarasa	bat
dengesizlik	imbalance
şasi	chassis
evrimsel	evolutionary
gösterileri	shows
kolesterol	cholesterol
güneşli	sunny
zeki	clever
i'inci	ith
topluluklar	communities
anten	antenna
aydınlatma	lighting
senaryolar	scenarios
gerekli	necessary
politika	policy
omuzlar	shoulders
kravatlar	ties
bakalorya	baccalaureate
iyimser	optimistic
mahaller	loci
kuleler	towers
akranlar	peers
markalar	brands
tartmak	weigh
hakaretler	insults
tohum	seed
bambu	bamboo
ölmek	die
haysiyet	dignity
yatçılık	yachting
güvenli	safe
önişlemci	preprocessor
mesafeler	distances
alıntıları	citations
bankalar	banks
bangladeş	bangladesh
sekreterlik	secretarial
trafik	traffic
kumtaşı	sandstone
açıklık	openness
misyonları	missions
muska	amulet
kelepçe	clamp
bastırıcı	repressive
ekran	screen
vah	woe
vahşi	wild
anonimlik	anonymity
maun	mahogany
akıcı	fluent
düzenlendi	edited
manevi	spiritual
istenmeyen	unwanted
kendim	myself
taşlar	stones
kotaları	quotas
mayınlı	mined
domuzcuk	piggy
kulak	ear
ses	voice
höyükler	mounds
ödülleri	awards
erotik	erotic
topal	lame
kıvılcımlar	sparks
bülten	bulletin
taslaklar	drafts
müttefik	allied
sosyoekonomik	socio-economic
katolik	catholic
yerler	places
faydalı	helpful
heyecanlandırmak	excite
sarmak	wrap
kivi	kiwi
tebeşir	chalk
halter	barbell
karine	presumption
elmaslar	diamonds
merkezkaç	centrifugal
yapıştırıcı	adhesive
yasak	forbidden
tazılar	hounds
sertleştirme	hardening
enflasyon	inflation
geko	gecko
metre	meter
kesiciler	breakers
e-posta	email
rahibeler	nuns
keçeleşmiş	matted
düzenlilik	regularity
mitoloji	mythology
dvd'ler	dvds
avustralya	australia
devlet	state
harabe	ruin
semptomlar	symptoms
arızalı	defective
staj	internship
felç	paralysis
vücutlu	bodied
ekmek	bread
asit	acid
profesörler	professors
soruşturmacı	ombudsman
şecere	genealogy
türler	species
şampiyonlar	champions
kızılötesi	infrared
erimiş	molten
hızlanma	acceleration
peygamber	prophet
köpek	dog
hareketlilik	mobility
müzeler	museums
antropolojik	anthropological
lop	lobe
farkedilebilir	noticeable
bant	band
purolar	cigars
vermek	give
protestocular	protesters
izlenim	impression
yüzey	surface
matbaacılık	typography
kore	korea
damar	vein
çöpçatanlık	matchmaking
kir	dirt
görünmeyen	unseen
yataklar	beds
zarflar	envelopes
işlemci	processor
terör	terror
müminler	believers
pisi	kitty
hakem	referee
kablo	cable
kaydırma	scroll
düzeltmeler	corrections
mississipi	mississippi
likidite	liquidity
karakter	character
alkışlanan	acclaimed
meşe	oak
aşağılama	humiliation
modülasyon	modulation
fermuarlı	zippered
şemaları	schemes
aksan	accent
koreli	korean
üye	member
üst	top
indüksiyon	induction
stoklu	stocked
versiyon	version
eşcinsel	gay
yaratıcı	creative
kendimizi	ourselves
zindan	dungeon
kosova	kosovo
hastalar	patients
taneler	grains
merkezi	center
yinelenme	recurrence
saksofon	saxophone
iltica	asylum
pansumanlar	dressings
kuvvetlice	vigorously
stafilokok	staphylococcus
elektrikçi	electrician
satın	buy
gezegen	planet
yapımları	productions
verimli	efficient
langırt	pinball
iklim	climate
prosedürler	procedures
eş	spouse
tüfekler	rifles
karton	cardboard
vücut	body
gürcistan	georgia
yağma	spoil
öykü	story
rezervasyonları	reservations
idare	govern
duyarlılık	sensitivity
isviçre	switzerland
disiplinlerarası	interdisciplinary
istekli	willing
lankalı	lankan
panoları	boards
başarı	success
sinagog	synagogue
kelepçeler	clamps
tutucular	holders
tembel	lazy
iyi	well
biz	we
hava	weather
orkestra	orchestra
örs	anvil
teleskoplar	telescopes
davetiye	invitation
ampul	bulb
haham	rabbi
bal	honey
eğimli	inclined
bağlı	depend
jöle	jelly
bozukluklar	disorders
algoritma	algorithm
garantiler	guarantees
beton	concrete
enzimatik	enzymatic
çoklu	multiple
mikroelektronik	microelectronics
elektrikçiler	electricians
astronot	astronaut
kaz	goose
geliştiriciler	developers
piyasalar	markets
ekili	cultivated
sofya	sophia
motor	engine
nüfuslu	populated
gif'ler	gifs
oturma	sitting
yaklaşan	approaching
kümeler	clusters
işaretleme	marking
sektörel	sectoral
kutluyor	celebrating
kutlamaları	celebrations
nemli	damp
ürün	product
spektrometre	spectrometer
riskli	risky
antrenörlük	coaching
evetler	yeas
jeneratörler	generators
bölge	region
hizmetçi	maid
asteroit	asteroid
sağoi	hanks
kurdeşen	hives
aztek	aztec
belge	document
mevcut	available
borçlular	debtors
guyanası	guiana
durum	status
e-tablolar	spreadsheets
olur	would
kıyı	shore
açıklıyor	explains
çilekler	strawberries
görünüşte	seemingly
tekneler	boats
astrolojik	astrological
optimizasyonlar	optimizations
fırsatlar	opportunities
dizinleri	directories
tehdit	threatening
esneklik	flexibility
raylar	rails
gizler	hides
sayılır	counted
yangınlar	fires
belirsiz	uncertain
vakıf	foundation
italik	italic
balkanlar	balkans
belirsizlikler	uncertainties
kanolar	canoes
bina	building
tanrııı	gaa
vericiler	makers
stüdyoları	studios
kaplama	covering
biyometrik	biometric
tutmak	keep
kurulu	board
fakat	but
velet	brat
seven	loving
yan	side
multidisipliner	multidisciplinary
rüya	dream
karga	crow
gözenek	pore
koşullar	conditions
ayrıldı	left
biliyordu	knew
ipuçları	tips
özlü	concise
öğretmenler	teachers
yetişkinler	adults
davranmak	behave
gezmek	wander
kaşık	spoon
daire	circle
kamyon	truck
hızlanan	accelerating
alçı	plaster
aktive	activated
iddia	claim
çiçeklenme	blooming
radyo	radio
susturucu	muffler
karışım	mixture
promosyonlar	promotions
basitçe	simply
devremülk	timeshare
kıymık	splinter
margarin	margarine
varil	barrel
takvim	calendar
kuzgun	raven
durgunluk	recession
buz	ice
ancak	but
kreps	craps
enfekte	infected
çekiş	traction
kusursuzca	perfectly
saçakbulut	cirrus
kurutucu	dryer
kalkık	raised
çözünürlükleri	resolutions
alkol	alcohol
etiyoloji	etiology
londra	london
kılavuz	guide
bireyler	individuals
monarşi	monarchy
önerme	proposition
mayo	swimsuit
söyle	tell
montajcılar	installers
dikdörtgen	rectangle
çevreciler	environmentalists
ontoloji	ontology
resital	recital
popülasyonları	populations
dilsiz	dumb
milyarlarca	billions
çalışkanlık	diligence
fidanlıkları	nurseries
kast	caste
egemenlik	sovereignty
kooperatif	cooperative
biyografik	biographical
emaye	enamel
akademisyenler	academics
özellikle	especially
turnuvalar	tournaments
dağıtılmış	distributed
yağlı	oily
belgeseller	documentaries
narin	delicate
depolanması	storing
buharlaştırma	evaporation
normalleştirme	normalization
sözleşmeli	contractual
hasarlı	damaged
kuşatma	siege
bekçi	guard
gerektirir	require
kasten	deliberately
imza	signature
kırgın	offended
bankacılık	banking
takviyeli	reinforced
tartışılan	debated
kristaller	crystals
kukla	puppet
embriyo	embryo
kısaltmalar	abbreviations
ülser	ulcer
büyütmek	enlarge
oteller	hotels
fışkırtma	squirt
isim	name
en	most
entrika	intrigue
ne	nor
tekerlekli	wheeled
kuru	dry
yönlendirilmiş	directed
tayvan	taiwan
büyümek	grow
kumarbazlar	gamblers
salyangoz	snail
üstsüz	topless
ciltli	hardcover
yıldönümü	anniversary
ağırlıklandırma	weighting
ejderha	dragon
ilik	marrow
programlar	programs
hedeflemesi	targeting
dioksit	dioxide
asetaminofen	acetaminophen
çıkarılabilir	detachable
sıçrayan	bouncing
msgstr	msgid
kod	code
muadilleri	counterparts
kişiler	persons
hırsız	thief
tekrarlayıcı	repeater
soslar	sauces
havayolu	airline
volkanik	volcanic
yetenekli	talented
ödenmemiş	unpaid
doğaçlama	improvisation
fikirli	minded
paydaşlar	stakeholders
tıklanabilir	clickable
yumurtalar	eggs
taviz	compromise
vaftiz	baptism
katoliklik	catholicism
akıncı	raider
hazar	caspian
cami	mosque
lanet	curse
uyarı	warning
adsız	unnamed
tartışmak	discuss
görüş	opinion
katliam	massacre
paradigmalar	paradigms
bisküvi	biscuit
rafine	refined
danslar	dances
tekler	singles
barometre	barometer
fısıldayan	whispering
müşterek	joint
organizma	organism
acele	rush
kompresörler	compressors
çingene	gypsy
teğmen	lieutenant
atıl	inert
anıtlar	monuments
tutulmuş	afflicted
raf	shelf
sel	flood
şişme	swelling
nahiye	township
görevleri	duties
elektronlar	electrons
sıradan	ordinary
şenlikli	festive
endeksleri	indices
roma	rome
sense	sense
bölmek	divide
alfabetik	alphabetical
kimyasallar	chemicals
çağırdı	urged
hakemler	referees
azim	perseverance
eğlenerek	amused
buda	buddha
esprili	witty
özetlenen	outlined
streptokok	streptococcus
dolapları	cabinets
kundakçılık	arson
yalancılar	liars
resif	reef
savuşturma	parry
kirli	dirty
atar	throws
yalınayak	barefoot
geldi	came
ödev	homework
gururla	proudly
kısıtlama	restriction
cihaz	device
ders	lesson
çalılar	shrubs
faşizm	fascism
açıldı	opened
kolaylaştırıcı	facilitator
özerklik	autonomy
kanarya	canary
karar	decision
yumruk	punch
belki	perhaps
silâhsızlanma	disarmament
ordular	armies
komünizm	communism
parmak	finger
önyargı	prejudice
balıkçılık	fishery
pratikte	practically
hristiyanlar	christians
ağrısız	painless
hevesli	enthusiastic
erik	plum
havariler	apostles
ormancılık	forestry
melekotu	angelica
kertenkele	lizard
tuval	canvas
soğutulan	cooled
tıbben	medically
unutulma	oblivion
üçgenler	triangles
ajans	agency
taht	throne
kaybetme	losing
reddetmek	reject
bisikletler	bicycles
ağırlıklar	weights
aşçı	cook
tamsayı	integer
fıstık	peanut
levrek	perch
deniz	sea
mızırdanmak	whine
sadece	only
bombus	bumble
bunalımlı	depressed
pragmatik	pragmatic
toskana	tuscany
yıl	year
metafiziksel	metaphysical
müteahhit	contractor
kıkırdak	cartilage
ayet	verse
pancar	beet
kayıplar	casualties
tutulma	eclipse
duvarcılık	masonry
sağir	deaf
alkışlamak	applaud
ağla	cry
etiketli	labeled
azınlık	minority
sone	sonnet
makine	machine
safsızlıklar	impurities
iskemik	ischemic
elektrot	electrode
gömlek	shirt
biyosentezi	biosynthesis
fetiş	fetish
kolaylığı	ease
tamamlayınız	complete
nesneleri	objects
kuzey	north
mantıklı	sensible
arduvaz	slate
panjur	blinds
valfler	valves
haliç	estuary
çaba	effort
hesaplama	calculation
arkasında	behind
mandıra	dairy
cetvel	ruler
parçalamak	smash
antijenler	antigens
ağaç	tree
sıvılar	liquids
kapitalist	capitalist
karşılaştırıldığında	compared
bariz	apparent
conta	gasket
karanlık	dark
dolaşım	circulation
matris	matrix
manganez	manganese
lobici	lobbyist
duyurular	announcements
turşu	pickle
cani	villain
homolog	homologous
kelime	word
testosteron	testosterone
sıçan	rat
armut	pear
kumul	dune
onbeşinci	fifteenth
desteklenmeyen	unsupported
zincir	chain
kritik	critical
satranç	chess
tartışılması	discussing
operasyonlar	operations
lityum	lithium
filtre	filter
çarpıtmalar	distortions
gizemli	mysterious
biçerdöver	harvester
kiriş	beam
silgi	eraser
sayısız	countless
birleştirmek	combine
tanıklık	testimony
potasyum	potassium
iyiliksever	benevolent
endişeye	worries
teklifleri	offerings
antilop	antelope
yoğunlaşma	condensation
rekombinant	recombinant
toksin	toxin
süpürge	broom
barındırılan	hosted
ahize	handset
bileşen	component
bitirmek	finish
mühür	seal
çıkarma	extraction
palyaço	clown
faydaları	benefits
priz	socket
taşınabilir	portable
dize	string
taşınan	transported
gömmek	bury
gruplandırılmış	grouped
bugün	today
onları	them
gerekir	should
tünel	tunnel
dirilik	vitality
dekor	decor
görünmek	seem
aylık	monthly
eğitimci	trainer
mecaz	metaphor
obsesif	obsessive
otistik	autistic
sensörler	sensors
antimikrobiyal	antimicrobial
öneri	proposal
dölleme	fertilization
çabaları	efforts
şamandıra	buoy
kamçılama	whipping
başlangıçta	initially
plantasyonları	plantations
eksiklikler	shortcomings
flop	flops
alt	lower
içtenlikle	sincerely
küratöryel	curatorial
otoyol	motorway
kolit	colitis
taksonomisi	taxonomy
bilekliği	wristbands
gazetecilik	journalism
rönesans	renaissance
gösterge	indicator
atlar	horses
güdümlü	guided
ekonometrik	econometric
kirpi	hedgehog
bölünmeler	divisions
fizyolojik	physiological
interaktif	interactive
soru	question
süspansiyonlar	suspensions
otlar	herbs
dışlamaları	exclusions
kokan	smelling
orospu	bitch
hatta	even
mineraller	minerals
sektörler	sectors
bar	bar
konvansiyonlar	conventions
vatansever	patriotic
hafifçe	slightly
kırat	carat
küre	sphere
pirinç	rice
ceket	coat
dalga	wave
bankacı	banker
koğuş	ward
derleyici	compiler
sinerji	synergy
takılarak	attaching
filmografi	filmography
paralar	moneys
bataklıklar	marshes
panter	panther
işte	here
kemirgen	rodent
şehit	martyr
sabırsız	impatient
neoplazma	neoplasm
kabarcıklar	bubbles
kuytu	nook
dayanmak	withstand
üzerinden	out
genler	genes
bana	me
yaylar	springs
korsanlık	piracy
üzerinde	over
dirençler	resistors
hayal	imagine
kaldırma	lifting
paralellikler	parallels
kaldırdı	lifted
bakım	care
kaynak	source
özelleştirilebilir	customizable
pelikan	pelican
kilim	rug
makrolar	macros
sitoloji	cytology
mantıksız	illogical
dağ	mountain
çıkma	emergence
işlemekle	committing
kova	aquarius
zincirler	chains
sinemalar	cinemas
itilmiş	pushed
hesapları	accounts
yükleyici	loader
önleme	prevention
oluşuyordu	consisted
göçebe	wandering
şehriye	noodle
konsolları	consoles
şirket	company
uygulayıcıları	practitioners
kızartma	frying
beklenen	expected
gübre	fertilizer
salı	tuesday
ucuz	cheap
atama	assignment
kronik	chronic
sırasıyla	respectively
kahvaltılar	breakfasts
antlaşma	treaty
cins	genus
demet	bundle
eşlenik	conjugate
denizler	seas
katılımcı	participant
çukurlar	pits
yönetici	manager
kısaltması	acronym
oybirliğiyle	unanimously
fırçalar	brushes
uluma	howl
nadir	rare
başyazı	editorial
belgesel	documentary
kiralamada	charters
jakuzi	jacuzzi
işaretçi	pointer
yenilenmiş	renovated
norveççe	norwegian
onarılmış	repaired
panelistler	panelists
dönen	rotating
itaatkâr	submissive
tropikal	tropical
tekstil	textile
benimsemek	adopt
silâhlı	armed
yatırımcılar	investors
herbisit	herbicide
kurumlar	institutions
teknik	technical
etkileyen	affecting
çoğu	most
kırışık	crease
kabartma	relief
uçları	ends
astronotlar	astronauts
hayali	imaginary
çevreleyen	surrounding
şüphe	doubt
açısal	angular
nakleder	conveys
molası	break
artım	increment
ekoloji	ecology
ruh	spirit
başarısız	unsuccessful
ayrıştırıcı	parser
heykelcik	figurine
heterojen	heterogeneous
bellingham-	bellingham
manastır	monastery
ibranice	hebrew
mezhep	sect
prototip	prototype
gönüllü	volunteer
resepsiyonlar	receptions
reaktifler	reagents
teşvikler	incentives
iki	two
spesiyalleri	specialties
demirleme	anchorage
sefalet	misery
olay	event
akupunktur	acupuncture
profesyoneller	professionals
bitmiş	finished
espriler	jokes
desen	pattern
tavşan	rabbit
sıklık	frequency
attı	threw
bölüm	quotient
porselen	porcelain
manda	mandate
spektrum	spectrum
sivrisinek	mosquito
buzdolapları	refrigerators
sıkıntılardan	woes
biftek	steak
para	money
matematik	maths
kapsülleme	encapsulation
öğretmek	teach
ekranlar	screens
suudi	saudi
ısıtıcılar	heaters
tüccarlar	traders
beklenmedik	unexpected
sağırlık	deafness
füme	smoked
bilinçsizce	unconsciously
prosedürel	procedural
yoğunlaştı	intensified
parazitler	parasites
uygun	appropriate
umutsuzluk	despair
temsilci	representative
ruj	lipstick
satıldı	sold
savurma	tossing
sağduyulu	discreet
bazlar	bases
ön	front
spartalı	spartan
paragraf	paragraph
saltanat	reign
kurallar	rules
özetlemek	summarize
düşüşler	declines
işleme	processing
vatikan	vatican
baba	dad
amblem	emblem
sonbahar	autumn
cerrahi	surgical
çarpmak	bump
dipleri	bottoms
floransa	florence
kopya	copy
kekik	thyme
plazmalar	plasmas
alternatif	alternative
kuşlar	birds
azaltılmış	diminished
sosyalist	socialist
aksiyon	action
kaput	bonnet
indirgeme	reduction
ahududu	raspberry
alkolizm	alcoholism
gurur	pride
açacak	opener
noter	notary
hakkında	about
kaynaşık	fused
sergiledi	exhibited
fayans	tile
dağıtmak	distribute
cezalandırmak	punish
binutils'ler	binutils
folyo	foil
misyonerler	missionaries
cezalandırılabilir	punishable
yetenekleri	capabilities
mısır	egypt
güçlüce	powerfully
mafya	mafia
ıpx	ipx
roketler	rockets
kıssa	parable
zahmetsizce	effortlessly
lezyonlar	lesions
işgalcilere	occupants
görünmez	invisible
iridyum	iridium
ikilemler	dilemmas
kokulu	fragrant
içti	drank
smokin	tuxedo
doktorlar	doctors
göndermek	send
iletişimci	communicator
gıdıklama	tickling
acımış	rancid
kararsızlık	instability
katsayı	coefficient
köri	curry
yayıncılar	publishers
başladı	started
kurbağalar	frogs
estonyalı	estonian
müfettiş	inspector
derecelendirilmemiş	unrated
çapraz	cross
zararsız	harmless
tornavida	screwdriver
kayıtlar	records
bulanık	blurred
ağız	mouth
projeler	projects
karşısında	against
elmalar	apples
çocukluk	childhood
astrofizik	astrophysics
batı	west
efsaneler	legends
ansiklopediler	encyclopedias
aziz	saint
gerginlik	tension
yıpratmak	fret
deli	mad
inkübasyon	incubation
çalkantılı	turbulent
çizik	scratch
koloniler	colonies
kuruluş	establishment
etrafında	around
antibiyotikler	antibiotics
enjektör	injector
servet	fortune
yuvarlanan	rolling
dağınıklık	clutter
türkler	turks
niyetler	intentions
utanmış	ashamed
muhtemel	probable
senfonik	symphonic
gibi	like
dekoratif	decorative
denetlenmemiş	unaudited
dağcılık	mountaineering
bahreyn	bahrain
güçsüz	powerless
sek	sec
bir	one
insan	human
tounhouse	townhouses
tekerlekler	wheels
medeniyet	civilization
hizmetler	services
mahmuzlar	spurs
suluboya	watercolor
mareşal	marshal
gerçi	though
skorlar	scores
şefleri	chiefs
kaykay	skateboard
hemen	immediately
fragman	fragment
ihlal	breach
prestijli	prestigious
macarca	hungarian
ödüllü	award-winning
afrika	africa
silindi	deleted
açlık	hunger
unutulmuş	forgotten
klarnet	clarinet
terminoloji	terminology
atlı	equestrian
atletizm	athletics
korkutucu	scary
vektör	vector
may	may
arabalar	cars
alfa	alpha
amaçlar	purposes
şampiyon	champion
yapmak	make
kriptografik	cryptographic
liderler	leaders
korucu	ranger
festivaller	festivals
marksizm	marxism
durumlar	situations
baskınlar	raids
süspansiyon	suspension
yardımlar	grants
hiç	ever
kısıtlayıcı	restrictive
navigasyon	navigation
kimlikler	identities
kalan	remaining
çeviklik	agility
açıklama	explanation
komşular	neighbors
candan	cordially
kese	pouch
çimen	grass
frank	franc
kızarmış	fried
babalık	paternity
böler	splits
havalandırma	ventilation
plasebo	placebo
ebeveyn	parent
numune	sample
adaylık	candidacy
tedarikçileri	suppliers
kayma	slip
girinti	recess
yakınsama	convergence
müteessir	touched
buzdolabında	refrigerated
seramikler	ceramics
minyatürler	miniatures
statik	static
bölüm	part
arayüzleri	interfaces
menenjit	meningitis
radyoaktif	radioactive
sabitleme	fixing
küfürlü	abusive
hacı	pilgrim
kıyaslamalı	comparative
habitatları	habitats
uçuculuk	volatility
sonuçlandırmak	finalize
brik	brig
kolombiyalı	colombian
spektral	spectral
takımlar	teams
ortopedi	orthopedics
kasabalar	towns
bekler	waits
papağan	parrot
uymak	comply
gaz	gas
temizlik	cleaning
borçluluk	indebtedness
sopranolar	sopranos
dejenerasyon	degeneration
fraktal	fractal
kobalt	cobalt
ani	sudden
gönderme	sending
kesinlikle	exactly
değerli	valuable
çığlıklar	screams
lokalize	localized
karakurbağası	toad
oyunlar	games
mutlulukla	happily
önlemler	measures
kinazlar	kinases
belirleme	determination
sunucular	servers
anakart	motherboard
manevra	maneuver
imparatorluklar	empires
dengeli	balanced
boğalar	bulls
duymuş	heard
atılan	discarded
tanklar	tanks
beyrut	beirut
yayma	spreading
obua	oboe
ahşap	wooden
skart	scart
belgesiz	undocumented
atol	atoll
hesap	account
füze	missile
tamponlar	buffers
öncelik	priority
elektriklenmiş	electrified
tez	thesis
bakış	glance
bmmyk	unhcr
kuvvet	force
bayt	byte
derinlikleri	depths
gelin	bride
çeltik	paddy
cesur	brave
sardunya	sardinia
sıkmak	tighten
muaf	exempt
tahmini	estimated
saflaştırılmış	purified
işemek	pee
metabolik	metabolic
imzalar	signatures
alabalık	trout
inciler	pearls
umutsuz	desperate
vibratör	vibrator
jeton	token
sırasında	during
vardı	were
düşünülebilir	conceivable
endokrin	endocrine
bayraklı	flagged
siteler	sites
avlanan	hunted
kullanım	use
alma	taking
ligler	leagues
plazma	plasma
ademi	decentralization
uyanış	awakening
ısıtma	heating
dayanışma	solidarity
sörfçü	surfer
yaka	collar
saptırma	diversion
barınak	shelter
kocalar	husbands
dönüştürmek	convert
etkinleştirme	activation
kaba	rude
redüktaz	reductase
benzerlikler	similarities
kazançlı	lucrative
özgünlük	originality
kategori	category
üfürükçü	healer
katı	solid
hipotez	hypothesis
denetlenmiş	audited
mücadeleler	struggles
üstün	superior
geliştirmek	develop
farmakolojik	pharmacological
bilge	wise
amerika	america
kale	castle
pazar	market
glutamin	glutamine
şahinler	hawks
çiçekli	flowering
biyoloji	biology
ucubeler	freaks
gaus	gauss
iltihaplı	inflammatory
savan	savannah
lahana	cabbage
stratejiler	strategies
favori	favorite
ısıtıcı	heater
süperstar	superstar
arabistan	arabia
isyan	revolt
feribot	ferry
cevaplar	answers
broş	brooch
sahnelemek	enact
sessiz	silent
çoban	shepherd
aciller	emergencies
ayaklı	footed
marjlar	margins
efekt	effect
antartik	antarctic
fark	difference
tramvay	tram
kaldırımlar	sidewalks
mühendislik	engineering
merkür	mercury
kapak	cover
donanma	navy
siğiller	warts
mastürbasyon	masturbation
muhalefet	opposition
ayırma	separation
huzursuzluk	unrest
süpernova	supernova
ezme	crushing
ifade	phrase
kamuflaj	camouflage
yapımcı	producer
mali	financial
düzeltmek	fix
ekonomik	economic
toka	clasp
emniyetsiz	unsafe
dersler	lessons
heveslilik	responsiveness
onaylamak	confirm
masaüstü	desktop
yüz	hundred
hippi	hippie
kaprisli	whimsical
triatlon	triathlon
sorular	questions
belirtmek	specify
sitokinler	cytokines
perdeler	curtains
madenler	metals
dayandırılabilir	attributable
ateşkes	truce
aç	hungry
kazıklar	stakes
oluklu	corrugated
belgeli	documented
beyzbol	baseball
trambolin	trampoline
kereste	timber
konuşmalar	speeches
kapanış	closing
ticarileştirilmesi	commercialization
kaybedenler	losers
relativistik	relativistic
karışan	interfering
safarileri	safaris
yönetim	governance
ikincil	secondary
türetmek	derive
ıslak	wet
yıkama	wash
baykuş	owl
iptaller	cancellations
gerekir	must
kutlama	celebration
patlayıcılar	explosives
arşivleme	archiving
dipol	dipole
yükseklikleri	heights
simgeler	icons
saldırılar	attacks
dönemleri	periods
mor	purple
nispet	defiance
kampus	campus
bellek	memory
transgenik	transgenic
bizi	us
izin	allow
kanalizasyon	sewage
reformasyon	reformation
sembol	symbol
ağızlar	mouths
rahat	comfortable
proje	project
soyulmuş	peeled
desenli	patterned
sürücü	driver
çince	chinese
gazeteler	newspapers
kaybeder	loses
enjeksiyonlar	injections
hızlandırılmış	accelerated
kendi	own
görsel-işitsel	audiovisual
harfler	letters
nakliyatçılar	shippers
gururlu	proud
yükseklik	height
arterler	arteries
ayçiçeği	sunflower
tüketim	consumption
tekno	techno
kucaklamak	embrace
koalisyon	coalition
planlama	planning
yedinci	seventh
gemi	ship
tıkanıklık	congestion
anarşi	anarchy
kilolu	overweight
sürüklenme	drift
gözlük	glasses
feci	disastrous
vaiz	preacher
elektron	electron
prens	prince
tutuculuk	conservatism
simyager	alchemist
arasında	among
doktor	doctor
yargıçlar	judiciary
gaddar	grim
seyreltme	dilution
ütüleme	ironing
müteahhitlik	contracting
vikinglerin	vikings
mühendis	engineer
boynuzlamak	cuckold
çıkarmadan	removing
yenilemek	renew
prensip	principle
iletkenlik	conductivity
motosiklet	motorcycle
kromozom	chromosome
onun	his
kahverengiler	browns
cilalı	polished
vajinalar	vaginas
yerleşme	settlement
kuraklık	drought
kordon	cord
sildim	erased
taksiler	taxis
kokular	scents
çamlar	pines
günler	days
gitmiş	gone
fotoğrafçılık	photography
izinler	permissions
banyolar	bathrooms
tartı	weighing
tıbbi	medical
tutarsız	inconsistent
nerelerde	whereabouts
çetele	tally
çimdik	tweak
iktisatçı	economist
demokratik	democratic
gergedan	rhino
davranışsal	behavioral
avrupalılar	europeans
basmış	ridden
mikroskoplar	microscopes
sepetler	baskets
tazmanya	tasmania
bosnalı	bosnian
tonozları	vaults
catch	catch
delicesine	insanely
reklamlar	advertisements
kaşıntılı	itchy
kazı	excavation
meydancı	fielder
tayın	ration
fizibilite	feasibility
mart	march
düşmüş	fallen
preslenmiş	pressed
yumurtlamak	spawn
koymak	put
renkli	colored
sapmalar	deviations
kitle	mass
vizyonlar	visions
çiçero	cicero
kesinleşmiş	finalized
planlamacıları	planners
demek	meant
kırbaç	whip
yakın	near
küreselleşme	globalization
tomurcuklar	buds
hoşgörülü	tolerant
mutasyonlar	mutations
yayınlar	publications
fantezi	fantasy
reaktivite	reactivity
eşdeğer	equivalent
koçanları	stubs
danışman	consultant
boşluklar	gaps
yenilik	innovation
arayüzey	interface
pozisyonları	positions
dağlık	mountainous
animasyon	animation
değerlendirilir	evaluated
spagetti	spaghetti
boyun	neck
yukarıdaki	above
fizikçi	physicist
gürültü	noise
kalabalıklar	crowds
mikrodizin	microarray
iplikler	yarns
dökme	pouring
tasarruf	saving
nikotin	nicotine
yerinden	displaced
kaslar	muscles
grup	group
kabileler	tribes
örtüşen	overlapping
resepsiyonist	receptionist
döşenmiş	appointed
leylak	lilac
konuşmacı	speaker
kaplinler	couplings
sahneleme	staging
künt	blunt
sekoya	redwood
güncellenmiş	updated
pazarlanan	marketed
metin	text
kurmayları	staffs
alışılagelmiş	customary
yanmak	burn
değiştiriciler	changers
her	each
rütbe	rank
yetkili	authorized
sağlamak	provide
lav	lava
uyarlanabilir	adaptable
sabah	morning
telefonculuk	telephony
sürdürücü	maintainer
bencil	selfish
takım	team
kayın	beech
değiştirmek	vary
şenlikler	festivities
miras	heritage
konserler	concerts
yer	place
sınavlar	exams
akort	tuning
ayrıcalık	privilege
animasyonlar	animations
arkadaşı	friend
basitleştirmek	simplify
hatırlıyorum	remember
yanında	beside
konseyler	councils
çiftçiler	farmers
baştankara	tit
desenler	patterns
açılmamış	unopened
kazanılması	recovering
kalkanlı	shielded
savunucuları	defenders
dilbilgisi	grammar
patoloji	pathology
şiir	poetry
otoriter	authoritarian
meksikalı	mexican
sekizinci	eighth
termostat	thermostat
yutturmaca	hype
kırıklar	fractures
çiftçi	farmer
patlama	explosion
ebeveynlik	parenthood
özel	special
koltuklar	seats
aşçılar	cooks
atölye	workshop
dönüşümcü	transformational
süpermarketler	supermarkets
nokta	spot
dermatit	dermatitis
görüş	sight
tahlilleri	assays
soğutucular	coolers
bekleyin	wait
topluluk	community
caydırıcı	deterrent
sinek	fly
emkt	ests
arayıcı	seeker
galler	wales
solucan	worm
sloganlar	slogans
binme	riding
kreasyonları	creations
limon	lemon
öncül	premise
maskeler	masks
madencilik	mining
derili	skinned
maskot	mascot
medya	media
koni	cone
dijital	digital
kramplar	cramps
konsey	council
piç	bastard
ülserler	ulcers
dürtü	impulse
yazar	author
yaratmak	create
karpuz	watermelon
aktörler	actors
ege	aegean
saldırma	attacking
fermuar	zipper
akşamları	evenings
sünger	sponge
golcü	scorer
bankacılar	bankers
ipek	silk
uzak	far
duygular	feelings
prensipler	principles
kim	who
teşebbüslerin	undertakings
koşu	running
kaçınma	avoidance
metastatik	metastatic
aksama	hitch
katılımcılar	participants
dekorasyonlar	decorations
sülfür	sulfur
gidiyor	going
yetişkinlik	adulthood
büyük	great
ölçmek	measure
komple	complete
deneyimler	experiences
homeopatik	homeopathic
çınlama	ringing
antik	antique
oturur	sits
biberiye	rosemary
muhabir	correspondent
hileli	fraudulent
hipotezler	hypotheses
ödeme	payment
kesin	exact
kurucu	founder
reformlar	reforms
temeller	foundations
jokey	jockey
malikâne	manor
oturmak	sit
sinematik	cinematic
saldırı	attack
yapışkan	sticky
aletleri	appliances
dini	religious
tutuklandı	arrested
misk	musk
bölümsel	sectional
mors	morse
evlilikler	marriages
levha	sheet
kodlar	codes
yapışma	adhesion
bisikletçileri	bikers
saç	hair
kâr	profit
çizim	drawing
maskara	mascara
merkezi	central
akan	flowing
nükleik	nucleic
tedaviler	treatments
devrimci	revolutionary
sözleşmeler	contracts
namibya	namibia
bale	ballet
benlik	ego
kiropraktörler	chiropractors
sıtma	malaria
geçti	passed
ortamları	environments
entomoloji	entomology
moloz	rubble
kehanet	prophecy
melekler	angels
ahşap	wood
karamel	caramel
heykel	statue
nesil	generation
bunaklık	dementia
yansıtıcı	reflective
tutma	holding
oktan	octane
milyar	billion
kibar	polite
dokumacı	weaver
bahçecilik	horticulture
ödenek	allowance
olgunlaşma	maturation
peyzajlı	landscaped
tanışık	acquainted
streç	stretch
röle	relay
ultrason	ultrasound
korkutmak	scare
kazanmak	win
notlar	notes
tetikleme	triggering
küresel	spherical
yüzleri	faces
eşitleme	equalization
vibratörler	vibrators
sonsuz	endless
düzenlemeler	arrangements
eyfel	eiffel
klinisyenler	clinicians
hüküm	provision
şişelenmiş	bottled
süzülmüş	filtered
adaçayı	sage
sabotaj	sabotage
çöker	crashes
yalvarır	pleads
özellik	property
yıkandı	washed
kutsamak	bless
aldatılmış	deceived
hece	syllable
kapasitörler	capacitors
evraklar	documents
fil	elephant
bobin	coil
patojenler	pathogens
asli	substantive
zararlıları	pests
şifrelemek	encrypt
snowboard	snowboarding
başkomiser	superintendent
camiler	mosques
erektil	erectile
kılavuzlar	guides
grafik	graphic
çita	cheetah
antijen	antigen
dairesel	circular
kanepe	couch
astronomi	astronomy
kamyonlar	trucks
laleler	tulips
küfür	swearing
aktif	active
yarışmacılar	contestants
yönlü	directional
kafatasları	skulls
birimler	units
bilmeceler	riddles
elektroforez	electrophoresis
komedi	comedy
şiddetli	severe
kiraz	cherry
hazine	treasure
erkekçe	manly
monoksit	monoxide
cephanelik	arsenal
kontluk	county
sterilizasyon	sterilization
kümelenmiş	clustered
duyuran	announcing
titreşim	vibration
teleskop	telescope
kitleler	masses
bayraklar	flags
uğursuz	sinister
pişmanlık	regret
hikayeleri	stories
bakıcıların	caregivers
işlemciler	processors
iletmek	transmit
kahire	cairo
gıda	food
habis	malignant
yengeç	crab
çift	double
anlatılar	narratives
gözlü	eyed
gezgin	traveler
konaklama	accommodation
konfigürasyonları	configurations
kafes	cage
kas-iskelet	musculoskeletal
dilim	slice
düzenlemek	arrange
değerlendirme	evaluation
namaz	prayer
günahkarlar	sinners
terbiyeli	seasoned
salıncak	swing
atanmamış	unassigned
silindirik	cylindrical
prizler	sockets
çimler	lawns
hamur	dough
hatırlatarak	recalling
quincy'nin	quincy
hırvat	croatian
kızarmak	blush
oyulmuş	carved
yenilenme	regeneration
sosyoloji	sociology
kardeş	brother
milis	militia
komisyoncu	broker
şematik	schematic
özellikleri	properties
özlüyor	misses
kaşifler	explorers
birleşik	unified
noktalı	dotted
dayklar	dykes
kavga	fight
şartname	specification
lojistik	logistics
varsayılan	default
buton	button
ünitesi	unit
senetler	securities
reasürans	reinsurance
fenerler	lighthouses
flüt	flute
misyoner	missionary
abartılı	exaggerated
geniş	wide
zombi	zombie
çin	china
balinalar	whales
beyler	gentlemen
öpmek	kiss
yapıştırılan	pasted
özerk	autonomous
atmosfer	atmosphere
meme	breast
katlama	folding
dokunma	touch
diyotlar	diodes
volkanlar	volcanoes
asansörler	lifts
seçici	selective
uykucu	sleeper
geç	late
yelek	vest
diye	she
federalizm	federalism
sinekler	flies
öz	self
ağırladı	entertained
avize	chandelier
çizgili	striped
düzensiz	irregular
bölümler	sections
kosta	costa
buzdolabı	refrigerator
orta	middle
azalan	decreasing
geçerlik	validity
tavuk	chicken
dönüştürme	conversion
ilmi	scientific
emme	suction
mezgit	whiting
funda	heather
gündoğumu	sunrise
şaftlar	shafts
modifikasyonlar	modifications
peçeteler	napkins
dubleks	duplex
ustalık	mastery
birikim	accumulation
parametreler	parameters
caz	jazz
eşarp	scarf
müdahaleler	interventions
otlak	pasture
bayilikler	dealerships
gres	grease
depresyon	depression
kampçı	camper
başrahip	abbot
widget'ları	widgets
interlökin	interleukin
karmaşık	complex
etkileri	effects
prolog	prologue
rezerv	reserve
yırtmaç	slash
stok	stock
doğrudan	direct
yatık	leaning
iskoç	scots
suçlu	guilty
insanlı	manned
kenar	edge
pensilvanya	pennsylvania
kırınım	diffraction
hinduizm	hinduism
dinle	listen
etkileyici	impressive
jambon	ham
türkiye	turkey
sarışın	blonde
basil	bacillus
öpüşmek	kissing
şaka	joke
çılgınlık	frenzy
komodor	commodore
oynamak	play
şişe	bottle
karış	span
küvetleri	tubs
erişim	access
siyahlar	blacks
kabızlık	constipation
polinezya	polynesia
alerjiler	allergies
adalet	justice
kükreme	roar
knoppix'i	knoppix
yılanbalığı	eel
mide	stomach
zooloji	zoology
uzanır	extends
kanka	dude
perakendeci	retailer
haziran	june
çığlıkları	cries
nakli	transplant
ovalar	plains
istemsiz	involuntary
hizmet	service
alan	area
nesiller	generations
korumak	protect
girişimci	entrepreneur
sıçramaları	leaps
inandırıcı	convincing
gezginler	travelers
hiyerarşi	hierarchy
efsane	legend
menteşe	hinge
ufuklar	horizons
yıpranmış	worn
allel	allele
kurdele	ribbon
müthiş	terrific
okuyucu	reader
faktörler	factors
bariatrik	bariatric
parçacık	particle
savurgan	wasteful
yanlış	false
farklar	differences
pirana	piranha
karşılık	provisions
başparmak	thumb
vietnam	vietnamese
sosis	sausage
çözünür	soluble
goril	gorilla
din	religion
aday	candidate
alelacele	hastily
turnuva	tournament
sanatçı	artist
editoryalleri	editorials
duraksama	hesitation
barajlar	dams
paketlenmiş	packed
hintli	indian
mayın	mine
borular	piping
ilham	inspiration
kontrastlar	contrasts
değerler	values
çırak	apprentice
manolya	magnolia
dil	language
karmakarışık	chaotic
programcı	programmer
toprak	soil
yok	does
algoritmalar	algorithms
sonlandırma	termination
kravat	tie
aynalı	mirrored
çatışmalar	conflicts
belirleyici	decisive
gurme	gourmet
çürüme	decay
evren	universe
fesleğen	basil
gıcıklık	moods
yunanlılar	greeks
biçimli	shaped
keşfedilmemiş	undiscovered
gelişen	developing
girmek	enter
acil	urgent
standı	stand
mahsur	stranded
paspaslar	mats
dinamo	dynamo
sevimli	cute
ermenistan	armenia
elastik	elastic
terzi	tailor
sitokrom	cytochrome
düşmek	fall
koşucular	runners
dramatik	dramatic
diyet	diet
çobanpüskülü	holly
kayıtlı	registered
yükselmeler	elevations
mucizeler	miracles
sendikasyon	syndication
cizvit	jesuit
sayaçlar	counters
endojen	endogenous
öznel	subjective
kano	canoe
oklar	arrows
bilme	knowing
değişiklik	alteration
kanıtlanmış	proven
maceralar	adventures
vajina	vagina
i	noun
kalkan	shield
zorlukla	hardly
cep	pocket
baharat	spice
içeride	inside
tokat	slap
piçler	bastards
dopamin	dopamine
yarın	tomorrow
destekler	supports
talimatlar	instructions
milliyetçi	nationalist
gözlemler	observations
kablolar	cables
randevu	appointment
detaylandırma	detailing
cadılar	witches
set	set
toprak	earth
görme	seeing
kötü	bad
mitokondri	mitochondria
modelleme	modelling
tamamlanan	completed
büro	desk
sınırlı	limited
kucak	lap
katalizörler	catalysts
şeftali	peach
olağandışı	unusual
cinsel	sexual
arandı	searched
emülsiyon	emulsion
görünür	appear
acımasız	brutal
cinayet	murder
implantlar	implants
kurtuluş	liberation
yüzmek	swim
verir	gives
fotoğraf	photo
kral	king
akıtmak	drain
teklifler	offers
aralığı	range
kısaltılmamış	unabridged
güney	south
zaman	time
gözlemlemek	observe
mercan	coral
modaliteleri	modalities
akıcılık	fluency
iz	track
diskografi	discography
dağınık	messy
canlandı	revived
göbek	belly
iskandinav	scandinavian
gölet	pond
dinozor	dinosaur
anayasal	constitutional
lokavt	lockout
yönetmen	director
vurgulayan	emphasizing
küba	cuba
suçlamalar	accusations
hediyeler	gifts
kullanışlılık	usefulness
krallık	kingdom
elips	ellipse
yükselen	rising
federaller	feds
centreville	centerville
etanol	ethanol
burulma	torsion
kültürler	cultures
neden	cause
tavla	backgammon
gazap	wrath
etkilenmiş	affected
isteksiz	reluctant
öğretilen	taught
ağırlık	weight
törenleri	ceremonies
romancı	novelist
çömlekçi	potter
ringa	herring
normandiya	normandy
pembe	pink
termal	thermal
mersin	myrtle
yayın	broadcasting
düşünceler	thoughts
hayrete	stunned
slav	slavic
çarşafları	linens
hapsedilmiş	imprisoned
vcr'lar	vcrs
paçavra	rag
şizofreni	schizophrenia
süpermen	superman
marksist	marxist
sinema	cinema
banliyö	suburban
akuamarin	aquamarine
buzdağı	iceberg
artışlarla	increments
kanser	cancer
şahsen	personally
imkansız	impossible
psikozlu	psychotic
kriterleri	criteria
garajlar	garages
bisikleti	biking
inceleyerek	examining
sürünme	creep
parça	piece
kırtasiye	stationery
öyküleme	narration
ölümcül	fatal
küreleri	spheres
aranan	wanted
marjinal	marginal
neopren	neoprene
sinirler	nerves
süet	suede
sahtekâr	dishonest
avro	euro
kazalar	accidents
karalama	defamation
beşik	cradle
soruşturma	investigation
birlik	unity
göğüslü	breasted
akrilik	acrylic
tekmeler	kicks
yaş	age
transmisyon	transmission
epitelyum	epithelium
özdeş	identical
öğrenmek	learn
lizbon	lisbon
dördüncü	fourth
kapanır	closes
hayatları	lives
yalama	licking
davulcu	drummer
interkom	intercom
cumhuriyetçi	republican
iskeletler	skeletons
modül	module
algılamak	perceive
belirterek	specifying
başgösteren	looming
önleyici	inhibitor
fosiller	fossils
belli	certain
sansürsüz	uncensored
kullanışlı	useful
suşi	sushi
köstebek	mole
kabul	acceptance
yüzen	floating
katkı	contribution
kin	hatred
düzene	streamlining
neredeyse	almost
payı	share
yargı	judgment
huzurlu	peaceful
adamak	devote
iş	business
güve	moth
hareket	movement
zarif	elegant
laktoz	lactose
tanıklar	witnesses
şehirler	cities
kumarbaz	gambler
vadi	valley
çapak	burr
kartonlar	cartons
bilinçsiz	unconscious
fitilli	corded
garanti	warranty
doğu	east
alışkanlık	habit
tesadüf	coincidence
afet	disaster
fısıldadı	whispered
nanotek	nanotech
deneyin	try
fiske	flick
lider	leader
elmas	diamond
tümör	tumor
düşen	falling
turba	peat
coşku	enthusiasm
dürüstçe	honestly
katılmak	join
özverili	selfless
casuslar	spies
köpekler	dogs
kanun	law
zorluklar	difficulties
boyalı	painted
getirdi	brought
okunabilir	readable
kolye	necklace
meşruluk	legitimacy
piskopos	bishop
yirminci	twentieth
diferansiyel	differential
topoloji	topology
organik	organic
psikoterapi	psychotherapy
protesto	protest
vals	waltz
enfeksiyon	infection
sarhoş	drunk
belirten	indicative
inanç	faith
dolaylı	indirect
kuruş	penny
ile	through
gölgelik	canopy
giyilebilir	wearable
metafizik	metaphysics
saygın	reputable
kurul	committee
klorid	chloride
kalkış	departure
an	moment
olacak	will
standart	standard
sırlı	glazed
ekstreler	extracts
müze	museum
ustaları	masters
fare	mouse
tamirat	repairs
önbellek	cache
ihracatçıları	exporters
soyut	abstract
komutanlar	commanders
telekom	telecom
uzama	elongation
belirteçler	markers
yendi	beat
okuma	reading
yudum	sip
farmakoloji	pharmacology
içecekler	drinks
ayarlama	adjustment
indir	download
tutuklamalar	arrests
tacikistan	tajikistan
biberler	peppers
boğuldu	drowned
matematiksel	mathematical
konturlu	contoured
araziler	plots
bıçakçı	cutler
pürüzsüz	smooth
fiberglas	fiberglass
sıralaması	ranking
komplikasyonlar	complications
beyaz	white
atış	shot
vitrin	showcase
piksel	pixels
takla	tumble
örümcek	spider
sınıflandırmak	classify
belirsizlik	uncertainty
parola	password
gerektiren	requiring
darbe	blow
deterjan	detergent
ayılar	bears
sesleri	sounds
avantaj	advantage
cam	glass
çizikler	scratches
nedensel	causal
helis	helix
tarihçi	historian
ortasında	midst
hoşgeldiniz	welcome
gebelik	pregnancy
çirkin	ugly
tel	wire
portalları	portals
rehberlik	guidance
muhafazakâr	conservative
yönlendirenler	referrers
yönetmenlik	directing
kuduz	rabies
araştırma	research
somutlaşan	embodied
işletmek	operate
ödem	edema
koroner	coronary
gastroenteroloji	gastroenterology
süvari	cavalry
besleme	supply
dilenmek	beg
deha	genius
öngörür	predicts
işçilik	workmanship
tertemiz	immaculate
travma	trauma
kırmızı	red
çarpı	crossed
diyor	says
iskoçya	scotland
yalvaran	pleading
yargılar	judgments
elementler	elements
diyot	diode
inhale	inhaled
iğne	needle
sandviçler	sandwiches
duygulu	soulful
yat	yacht
vektörler	vectors
makedonya	macedonia
katmanlar	layers
metodist	methodist
koç	coach
laik	secular
dünyalar	worlds
çiçekler	flowers
alpaka	alpaca
müzisyenler	musicians
nakavt	knockout
biyoteknoloji	biotechnology
barınaklar	shelters
maskeli	masked
ölçme	measuring
asırlık	centenary
kondüktör	conductor
tümen	divisional
postalar	mails
bekledi	waited
aldı	took
düzine	dozen
çalıntı	stolen
zamanlayıcılar	timers
fiş	plug
susuzluk	thirst
tuvaletler	toilets
ihbar	notice
kameri	lunar
kırmızımsı	reddish
marş	anthem
tüketmek	consume
mezarlıklar	cemeteries
balerin	ballerina
nikaragua	nicaragua
solungaç	gill
siyasetçiler	politicians
mikroişlemci	microprocessor
tavuklar	chickens
segmenti	segment
gitti	gone
hayat	life
burada	here
vazo	vase
önceden	previously
anakartlar	motherboards
ekolojik	ecological
sorun	trouble
alıkoyma	retention
balast	ballast
temalar	themes
gökkuşağı	rainbow
burçlar	horoscope
duydum	heard
ağırlığındadır	weighs
playoff	playoffs
rotaları	trails
fizik	physics
tren	train
tutsaklık	captivity
siler	deletes
inatçı	stubborn
gizlice	secretly
patolojik	pathological
nakış	embroidery
titiz	rigorous
pırıltı	twinkle
trompet	trumpet
kullanılabilirlik	availability
etiketlendi	tagged
devam	continuation
anlar	moments
boşnakça	bosnian
uyarlanması	adapting
evrensel	universal
tırtıl	caterpillar
hidrojen	hydrogen
kardiyak	cardiac
taşımak	carry
getiriyor	brings
jeller	gels
reklâm	advertisement
yapıştırıcılar	adhesives
dürüstlük	honesty
hostes	hostess
partiler	parties
iplik	yarn
armoni	harmony
hipofiz	pituitary
mumlar	candles
gravür	engraving
kurban	victim
lehimleme	soldering
hiroşima	hiroshima
savaş	war
yengeçler	crabs
çeşitli	various
haki	khaki
anarşist	anarchist
karavan	caravan
köşe	corner
dojosu	dojo
atlama	jump
tatma	tasting
müdürlük	directorate
yarışma	competition
yaşlanma	aging
şampuan	shampoo
şey	thing
kör	blind
vakum	vacuum
zengin	rich
komedyen	comedian
mezarlık	cemetery
olgunlaşmamış	immature
atriyum	atrium
balıkçı	fisherman
arktik	arctic
tanıtımları	introductions
özellikle	particular
yıkıcı	devastating
entegratör	integrator
ağrı	pain
havacı	aviator
versiyonları	versions
eziyet	grind
polonya	poland
balonlar	balloons
aktrisler	actresses
çevrimdışı	offline
kaşkorse	camisole
havuç	carrot
markalı	branded
uzatılmış	elongated
oyuncak	toy
temsilcileri	representatives
yerliler	locals
kürk	fur
tekel	monopoly
simülatör	simulator
kumarhane	casino
nefret	hate
lordlar	lords
bütçeleri	budgets
masaj	massage
hemşirelik	nursing
rezervuar	reservoir
arkeoloji	archaeology
pişirmek	cook
sonra	after
uyumsuz	incompatible
samuray	samurai
parçalanma	fragmentation
seçilmiş	selected
enine	transverse
nükleotidleri	nucleotides
çerçeveler	frames
uçurumlar	cliffs
virüsler	viruses
galaksiler	galaxies
anlaşmak	agree
mrg	mri
jip	jeep
bakanlıklar	ministries
kolorado	colorado
varsayar	assumes
uygulamak	apply
kumarhaneler	casinos
agresif	aggressive
ithalatçıları	importers
güçlendirir	strengthens
sağlama	providing
yabancı	foreign
montaj	assembly
temizleyiciler	cleaners
cinsiyet	gender
kötülükler	evils
blokerleri	blockers
basketbol	basketball
teknolojiler	technologies
gölgeli	shady
basınç	pressure
barış	peace
ironik	ironic
yusufçuk	dragonfly
destekli	supported
bronz	bronze
durulama	rinse
kamlar	cams
güvensizlik	insecurity
meditasyon	meditation
muhtıra	memorandum
hasat	harvest
yönetmek	administer
az	few
koğuşları	wards
parametre	parameter
pankreas	pancreas
keneler	ticks
folklor	folklore
tamamlama	completion
kulübe	hut
müdahale	intervention
intoko	kijiji
dışında	outside
babalar	fathers
temiz	clean
psikoloji	psychology
fırınlar	ovens
tutun	hold
restorasyon	restoration
arap	arab
nakletme	transporting
perspektif	perspective
birdirbir	leapfrog
ensülin	insulin
yavrular	offspring
yumuşak	soft
kişilikleri	personalities
azalır	decreases
yoğun	intensive
doktrin	doctrine
kollu	sleeved
terapi	therapy
seçkin	distinguished
silecek	wiper
uçurum	cliff
korku	fear
harita	map
migren	migraine
litvanyalı	lithuanian
çilek	strawberry
fanlar	fans
rivierası	riviera
delilik	madness
başlık	title
gerçek	true
ana	main
monako	monaco
yaya	pedestrian
kanon	canon
beğenmemek	dislike
kobi'ler	smes
non-invazif	non-invasive
kaybetmek	lose
sırpça	serbian
tüketme	depletion
iniş	landing
giydirmek	clothe
telemetri	telemetry
haitili	haitian
titanlar	titans
kar	snow
sanallaştırma	virtualization
düşünürler	thinkers
koruma	protection
sayısallaştırılmış	digitized
anıt	monument
parklar	parks
leke	stain
eskortlar	escorts
deterministik	deterministic
şüpheliler	suspects
indi	landed
tokalar	buckles
cüzdan	wallet
şekil	shape
intikam	revenge
olduğunu	is
yerleşik	settled
etiket	tag
ulaşılabilirlik	accessibility
çapa	anchor
inançlar	beliefs
standları	stands
alaycı	cynical
başkanlar	presidents
türbülans	turbulence
numarası	number
reflektör	reflector
atlet	athlete
kartal	eagle
emekli	retired
simetri	symmetry
ekosistemler	ecosystems
lehçeleri	dialects
uzunlamasına	longitudinal
kekler	cakes
iyonlar	ions
tv'ler	tvs
sınıflandırılmış	classified
çelişkiler	contradictions
kartpostallar	postcards
üfleme	blowing
kontrolörleri	controllers
webloglar	weblogs
bıçak	knife
çöp	garbage
takozlar	wedges
mantık	logic
indirildi	downloaded
iletken	conductive
karıştırıcı	mixer
